"","County","TotPrecincts","PrecinctsReporting","Bush","Kerry","Nader","votes","p"
"1","Alaska",439,439,151876,86064,3890,241830,0.0832467685529936
"2","Autauga",22,22,15212,4774,74,20060,0.00690538881517203
"3","Baldwin",50,50,52910,15579,371,68860,0.0237041412668368
"4","Barbour",24,24,5893,4826,26,10745,0.00369882366994135
"5","Bibb",16,16,5471,2089,12,7572,0.00260656052385257
"6","Blount",26,26,17364,3932,92,21388,0.00736253519336487
"7","Bullock",27,27,1494,3210,3,4707,0.0016203222907784
"8","Butler",27,27,4978,3409,13,8400,0.00289158853676197
"9","Calhoun",53,53,29806,15076,182,45064,0.0155126840262668
"10","Chambers",24,24,7618,5346,42,13006,0.00447714291775311
"11","Cherokee",32,32,5919,3036,43,8998,0.00309744210164097
"12","Chilton",19,19,12824,3773,46,16643,0.00572913190682493
"13","Choctaw",33,33,3889,3289,15,7193,0.00247609480296772
"14","Clarke",30,30,6729,4627,19,11375,0.0039156928101985
"15","Clay",24,24,4622,1893,38,6553,0.0022557832954049
"16","Cleburne",19,19,4362,1387,24,5773,0.00198727864556272
"17","Coffee",34,34,13010,4477,73,17560,0.00604479698875478
"18","Colbert",36,36,13179,10586,88,23853,0.00821107873421228
"19","Conecuh",27,27,3266,2715,17,5998,0.00206473190994027
"20","Coosa",14,14,2902,2055,8,4965,0.00170913536726466
"21","Covington",37,37,11108,3422,37,14567,0.00501449645416804
"22","Crenshaw",19,19,3774,1698,17,5489,0.00188951541408172
"23","Cullman",53,53,26783,8022,155,34960,0.0120345161006188
"24","Dale",26,26,13614,4479,75,18168,0.00625409292093945
"25","Dallas",32,32,7318,11145,28,18491,0.00636528138491256
"26","DeKalb",77,77,16901,7092,99,24092,0.00829335131281777
"27","Elmore",31,31,22024,6455,68,28547,0.00982692594749331
"28","Escambia",34,34,8501,3812,28,12341,0.00424822549192612
"29","Etowah",53,53,26972,15311,195,42478,0.0146224878410208
"30","Fayette",28,28,5532,2408,29,7969,0.00274322250588763
"31","Franklin",25,25,7688,4513,48,12249,0.00421655571271397
"32","Geneva",31,31,8324,2105,27,10456,0.00359933925480751
"33","Greene",21,21,958,3763,12,4733,0.00162927244577314
"34","Hale",16,16,3278,4622,15,7915,0.00272463372243702
"35","Henry",20,20,4859,2432,15,7306,0.00251499355352178
"36","Houston",29,29,26868,9141,91,36100,0.0124269459734651
"37","Jackson",38,38,11507,8618,92,20217,0.00695943398187103
"38","Jefferson",379,379,158504,132145,999,291648,0.100395953996375
"39","Lamar",25,25,4894,1956,5,6855,0.0023597427880361
"40","Lauderdale",33,33,22123,14615,155,36893,0.0126999257008047
"41","Lawrence",32,32,7728,6153,44,13925,0.00479349647314409
"42","Lee",36,36,27911,16177,203,44291,0.0152465890335386
"43","Limestone",33,33,18994,8859,117,27970,0.00962830135395621
"44","Lowndes",14,14,1786,4233,0,6019,0.00207196088128218
"45","Macon",18,18,1540,7495,16,9051,0.00311568664836102
"46","Madison",83,83,77150,52614,548,130312,0.044858176833634
"47","Marengo",32,32,5242,5026,16,10284,0.00354013053715001
"48","Marion",22,22,8983,3806,61,12850,0.00442344198778467
"49","Marshall",50,50,22745,8441,154,31340,0.0107883791359667
"50","Mobile",90,90,91877,63614,697,156188,0.0537656464737831
"51","Monroe",14,14,5831,3666,23,9520,0.00327713367499689
"52","Montgomery",59,59,44074,45127,198,89399,0.0307744194759504
"53","Morgan",47,47,32435,14113,187,46735,0.0160879036030441
"54","Perry",18,18,1733,3754,7,5494,0.00189123659773455
"55","Pickens",27,27,5170,3915,24,9109,0.0031356523787339
"56","Pike",28,28,7473,4323,44,11840,0.0040757628899121
"57","Randolph",47,47,6127,2817,35,8979,0.0030909016037602
"58","Russell",19,19,8332,8372,51,16755,0.00576768642064842
"59","Shelby",65,65,63326,14826,283,78435,0.0270002079620149
"60","St Clair",36,36,23468,5449,95,29012,0.00998699602720692
"61","Sumter",21,21,1880,4527,10,6417,0.0022089671000478
"62","Talladega",37,37,18326,11373,89,29788,0.0102541237301268
"63","Tallapoosa",29,29,12378,5449,53,17880,0.00615495274253618
"64","Tuscaloosa",53,53,42827,26420,263,69510,0.0239278951417053
"65","Walker",45,45,19162,9012,108,28282,0.00973570321389308
"66","Washington",26,26,5042,3127,28,8197,0.00282170848045688
"67","Wilcox",29,29,1778,3238,19,5035,0.00173323193840434
"68","Winston",23,23,8052,2234,29,10315,0.00355080187579758
"69","Arkansas",30,30,3783,3105,31,6919,0.00238177393879239
"70","Ashley",24,24,4566,3879,38,8483,0.00292016018539902
"71","Baxter",42,42,11117,7120,154,18391,0.00633085771185587
"72","Benton",83,83,46173,20594,394,67161,0.0231192830616036
"73","Boone",29,29,9742,4617,117,14476,0.00498317091168645
"74","Bradley",16,16,2190,2005,21,4216,0.00145130205607005
"75","Calhoun",13,13,1334,934,10,2278,0.0007841712722314
"76","Carroll",29,29,6184,4161,76,10421,0.00358729096923767
"77","Chicot",11,11,1723,2815,23,4561,0.00157006372811563
"78","Clark",25,25,4118,4981,46,9145,0.00314804490103431
"79","Clay",19,19,2735,3258,45,6038,0.00207850137916295
"80","Cleburne",31,31,6938,4419,78,11435,0.00393634701403251
"81","Cleveland",20,20,2008,1450,22,3480,0.00119794382237281
"82","Columbia",19,19,5706,4102,39,9847,0.00338969908589227
"83","Conway",29,29,3998,3972,56,8026,0.00276284399952994
"84","Craighead",25,25,15810,13647,179,29636,0.0102017997470807
"85","Crawford",45,45,13353,6747,143,20243,0.00696838413686577
"86","Crittenden",42,42,6930,8278,53,15261,0.00525339674518147
"87","Cross",18,18,3864,3135,31,7030,0.00241998421588531
"88","Dallas",19,19,1699,1670,1,3370,0.00116007778201046
"89","Desha",23,23,1783,2818,28,4629,0.00159347182579418
"90","Drew",19,19,3279,2965,23,6267,0.00215733159046277
"91","Faulkner",47,47,21514,14538,231,36283,0.0124899412951589
"92","Franklin",30,30,4179,3005,62,7246,0.00249433934968776
"93","Fulton",18,18,2187,2083,37,4307,0.00148262759855164
"94","Garland",68,68,21699,18014,195,39908,0.0137377994434639
"95","Grant",20,20,4205,2524,25,6754,0.00232497487824885
"96","Greene",21,21,7232,6561,88,13881,0.00477835005699915
"97","Hempstead",29,29,3580,3817,28,7425,0.00255595772445924
"98","Hot Spring",29,29,5960,5901,136,11997,0.00412980805661111
"99","Howard",21,21,2728,2163,22,4913,0.00169123505727518
"100","Independence",30,30,7408,5428,72,12908,0.00444340771815755
"101","Izard",42,42,2833,2586,35,5454,0.00187746712851188
"102","Jackson",47,47,2617,3513,49,6179,0.00212703875817288
"103","Jefferson",208,208,10165,19536,327,30028,0.0103367405454629
"104","Johnson",21,21,4300,3621,18,7939,0.00273289540397062
"105","Lafayette",22,22,1595,1562,15,3172,0.00109191890935821
"106","Lawrence",23,23,2951,3543,59,6553,0.0022557832954049
"107","Lee",15,15,1491,2543,16,4050,0.00139415875879595
"108","Lincoln",27,27,1972,2190,27,4189,0.00144200766434475
"109","Little River",22,22,2574,2677,29,5280,0.00181756993739324
"110","Logan",31,31,5057,3357,67,8481,0.00291947171193788
"111","Lonoke",35,35,12860,6708,81,19649,0.00676390751890903
"112","Madison",27,27,3871,2420,42,6333,0.00218005121468018
"113","Marion",36,36,4102,2590,91,6783,0.00233495774343529
"114","Miller",28,28,8439,6135,58,14632,0.00503687184165489
"115","Mississippi",25,25,6090,7536,55,13681,0.00470950271088577
"116","Monroe",18,18,1585,2040,15,3640,0.00125302169926352
"117","Montgomery",16,16,2355,1518,37,3910,0.00134596561651658
"118","Nevada",21,21,1748,1688,16,3452,0.00118830519391694
"119","Newton",21,21,2778,1505,51,4334,0.00149192199027695
"120","Ouachita",23,23,5323,5171,48,10542,0.00362894361363627
"121","Perry",19,19,2435,1919,44,4398,0.00151395314103323
"122","Phillips",57,57,3138,5563,29,8730,0.00300518665784904
"123","Pike",15,15,2009,1310,26,3345,0.00115147186374628
"124","Poinsett",42,42,3554,4068,68,7690,0.00264718045805947
"125","Polk",20,20,5181,2468,73,7722,0.00265819603343761
"126","Pope",58,58,13614,7100,90,20804,0.0071615009427138
"127","Prairie",22,22,2029,1554,15,3598,0.00123856375657971
"128","Pulaski",133,133,65052,81291,611,146954,0.0505869645037283
"129","Randolph",26,26,3157,3411,35,6603,0.00227299513193325
"130","Saint Francis",25,25,3603,5486,42,9131,0.00314322558680637
"131","Saline",70,70,24833,14140,231,39204,0.0134954567851448
"132","Scott",28,28,2522,1477,32,4031,0.00138761826091518
"133","Searcy",18,18,2562,1352,15,3929,0.00135250611439735
"134","Sebastian",54,54,27251,16426,215,43892,0.0151092385780424
"135","Sevier",17,17,2513,2034,31,4578,0.00157591575253527
"136","Sharp",26,26,4090,3262,64,7416,0.00255285959388414
"137","Stone",31,31,3188,2255,60,5503,0.00189433472830965
"138","Union",32,32,10468,7056,62,17586,0.00605374714374951
"139","Van Buren",23,23,3719,3310,34,7063,0.00243134402799402
"140","Washington",116,116,35652,27530,387,63569,0.0218827847254073
"141","White",91,91,17001,9129,171,26301,0.00905377025064005
"142","Woodruff",13,13,1016,1969,16,3001,0.00103305442843127
"143","Yell",31,31,3660,2902,40,6602,0.00227265089520268
"144","Apache",45,45,8068,15082,0,23150,0.00796908031262375
"145","Cochise",64,64,24828,16219,0,41047,0.0141298850795796
"146","Coconino",83,83,20619,26513,0,47132,0.0162245655850792
"147","Gila",40,40,10494,7107,0,17601,0.00605891069470802
"148","Graham",18,18,7302,3141,0,10443,0.00359486417731014
"149","Greenlee",8,8,1899,1146,0,3045,0.00104820084457621
"150","La Paz",12,12,3158,1849,0,5007,0.00172359330994847
"151","Maricopa",1058,1058,539776,403882,0,943658,0.3248417446933
"152","Mohave",73,73,29608,16267,0,45875,0.0157918600147566
"153","Navajo",70,70,16474,14224,0,30698,0.0105673791549427
"154","Pima",401,401,138431,154291,0,292722,0.100765664245004
"155","Pinal",67,67,34813,25652,0,60465,0.0208142739137277
"156","Santa Cruz",24,24,4668,6909,0,11577,0.00398522862977301
"157","Yavapai",103,103,49675,30377,0,80052,0.0275568387553415
"158","Yuma",42,42,18398,12668,0,31066,0.0106940582717913
"159","Alameda",1141,1141,107489,326675,0,434164,0.149455195889848
"160","Alpine",5,5,311,373,0,684,0.00023545792370776
"161","Amador",57,57,10479,6211,0,16690,0.00574531103316157
"162","Butte",183,183,42645,35073,0,77718,0.0267533902261984
"163","Calaveras",30,30,12469,7750,0,20219,0.00696012245533216
"164","Colusa",17,17,3938,1858,0,5796,0.00199519609036576
"165","Contra Costa",921,921,130527,221449,0,351976,0.121163067478015
"166","Del Norte",19,19,5125,3736,0,8861,0.00305028166955331
"167","El Dorado",150,150,34514,21478,0,55992,0.0192745030179019
"168","Fresno",667,667,120272,85943,0,206215,0.0709867773938534
"169","Glenn",23,23,6299,2985,0,9284,0.00319589380658311
"170","Humboldt",139,139,23014,34270,0,57284,0.0197192568737943
"171","Imperial",152,152,11628,13955,0,25583,0.00880660827809302
"172","Inyo",31,31,4559,3021,0,7580,0.00260931441769711
"173","Kern",658,658,118571,57129,0,175700,0.0604823935606044
"174","Kings",140,140,16846,8788,0,25634,0.00882416435135193
"175","Lake",52,52,8185,9679,0,17864,0.00614944495484711
"176","Lassen",37,37,7373,2867,0,10240,0.00352498412100506
"177","Los Angeles",4602,4602,954764,1670341,0,2625105,0.903657562594824
"178","Madera",100,100,21881,11841,0,33722,0.011608351028177
"179","Marin",209,209,26141,73946,0,100087,0.0344536216522494
"180","Mariposa",21,21,4750,2961,0,7711,0.00265440942940137
"181","Mendocino",98,98,11963,22276,0,34239,0.0117863214178801
"182","Merced",106,106,29968,22403,0,52371,0.0180280218165192
"183","Modoc",20,20,2987,1049,0,4036,0.00138933944456801
"184","Mono",13,13,2200,2200,0,4400,0.00151464161449436
"185","Monterey",304,304,31382,48415,0,79797,0.027469058389047
"186","Napa",114,114,18886,28860,0,47746,0.0164359269376472
"187","Nevada",138,138,25078,20716,0,45794,0.0157639768395807
"188","Orange",2146,2146,455500,300490,0,755990,0.260239525941271
"189","Placer",391,391,84551,49519,0,134070,0.0461518184671044
"190","Plumas",29,29,6681,3923,0,10604,0.00365028629093141
"191","Riverside",1103,1103,263147,187823,0,450970,0.155240438383755
"192","Sacramento",926,926,171569,175725,0,347294,0.119551351105501
"193","San Benito",58,58,6158,7253,0,13411,0.0046165587936327
"194","San Bernardino",881,881,226133,175533,0,401666,0.138268190619885
"195","San Diego",2235,2235,439242,394752,0,833994,0.287091367872412
"196","San Francisco",578,578,41157,222013,0,263170,0.0905927803832912
"197","San Joaquin",527,527,87336,74868,0,162204,0.0558365746448736
"198","San Luis Obispo",160,160,53683,47079,0,100762,0.034685981445382
"199","San Mateo",522,522,66152,156570,0,222722,0.0766690931053212
"200","Santa Barbara",355,355,48451,60565,0,109016,0.0375273114194812
"201","Santa Clara",1088,1088,151660,280016,0,431676,0.148598734904197
"202","Santa Cruz",279,279,25297,74302,0,99599,0.0342856341277327
"203","Shasta",133,133,45392,20980,0,66372,0.0228476802811863
"204","Sierra",22,22,1429,646,0,2075,0.000714291215926319
"205","Siskiyou",86,86,10399,6545,0,16944,0.00583274716272556
"206","Solano",295,295,49710,69729,0,119439,0.04111529086218
"207","Sonoma",494,494,55541,119821,0,175362,0.0603660415456728
"208","Stanislaus",333,333,70981,49640,0,120621,0.0415221786777101
"209","Sutter",101,101,17329,8254,0,25583,0.00880660827809302
"210","Tehama",47,47,13384,6505,0,19889,0.00684652433424509
"211","Trinity",24,24,3406,2682,0,6088,0.00209571321569129
"212","Tulare",286,286,56556,27989,0,84545,0.0291034943857786
"213","Tuolumne",75,75,14001,8971,0,22972,0.00790780617458284
"214","Ventura",541,541,109007,103360,0,212367,0.073104521760301
"215","Yolo",132,132,24594,38190,0,62784,0.0216125588919123
"216","Yuba",45,45,10805,5064,0,15869,0.00546269267736615
"217","Adams",201,201,62485,65081,767,128333,0.0441769323438421
"218","Alamosa",9,9,3137,2975,39,6151,0.00211740012971701
"219","Arapahoe",363,363,114703,105008,1108,220819,0.0760140106070524
"220","Archuleta",10,10,2555,2111,40,4706,0.00161997805404783
"221","Baca",7,7,1673,482,11,2166,0.000745616758407907
"222","Bent",6,6,1310,757,21,2088,0.000718766293423689
"223","Boulder",227,200,43248,92870,810,136928,0.0471356470430646
"224","Broomfield",41,41,11847,10760,134,22741,0.00782828748982189
"225","Chaffee",15,15,4634,3595,73,8302,0.00285785333716641
"226","Cheyenne",7,7,902,193,7,1102,0.000379348877084725
"227","Clear Creek",11,11,2467,2899,45,5411,0.0018626649490975
"228","Conejos",10,10,1855,1889,19,3763,0.00129536281712325
"229","Costilla",9,9,547,1149,15,1711,0.000588989045999967
"230","Crowley",7,7,977,469,1,1447,0.000498110549130305
"231","Custer",4,4,1644,733,13,2390,0.000822725786054893
"232","Delta",20,20,9563,4165,104,13832,0.00476148245720137
"233","Denver",423,423,62868,148599,1213,212680,0.0732122678569684
"234","Dolores",4,4,785,333,9,1127,0.000387954795348897
"235","Douglas",142,142,79115,38956,406,118477,0.0407841351273747
"236","Eagle",29,29,8469,9630,117,18216,0.00627061628400666
"237","El Paso",378,378,157594,75558,1273,234425,0.0806976955631457
"238","Elbert",16,16,8292,3103,49,11444,0.00393944514460761
"239","Fremont",32,32,12241,5900,135,18276,0.00629127048784068
"240","Garfield",28,28,10937,9077,142,20156,0.00693843554130645
"241","Gilpin",6,6,1304,1772,22,3098,0.00106644539129626
"242","Grand",12,12,4170,3159,57,7386,0.00254253249196713
"243","Gunnison",15,15,3452,4730,93,8275,0.0028485589454411
"244","Hinsdale",4,4,355,234,4,593,0.000204132381226172
"245","Huerfano",11,11,1661,1628,24,3313,0.00114045628836814
"246","Jackson",6,6,710,209,7,926,0.00031876321250495
"247","Jefferson",325,325,137251,123174,1667,262092,0.0902216931877401
"248","Kiowa",4,4,688,167,3,858,0.000295355114826401
"249","Kit Carson",10,10,2668,723,23,3414,0.0011752241981554
"250","La Plata",30,30,11593,13266,193,25052,0.008623818574162
"251","Lake",8,8,1231,1574,38,2843,0.000978665025001699
"252","Larimer",31,31,74899,67266,978,143143,0.0492750783235379
"253","Las Animas",18,18,3152,3248,42,6442,0.00221757301831197
"254","Lincoln",11,11,1793,493,7,2293,0.000789334823189903
"255","Logan",18,18,6054,2426,56,8536,0.00293840473211906
"256","Mesa",82,82,40457,19072,407,59936,0.0206321726832578
"257","Mineral",1,1,381,227,6,614,0.000211361352568077
"258","Moffat",14,14,4210,1343,64,5617,0.00193357771559428
"259","Montezuma",13,13,6952,3839,87,10878,0.00374460715510675
"260","Montrose",22,22,11045,4708,98,15851,0.00545649641621594
"261","Morgan",18,18,6741,3017,63,9821,0.00338074893089753
"262","Otero",18,18,4832,3092,37,7961,0.0027404686120431
"263","Ouray",7,7,1383,1250,19,2652,0.000912915809463421
"264","Park",13,13,4739,3405,59,8203,0.00282377390084029
"265","Phillips",9,9,1661,565,13,2239,0.000770746039739291
"266","Pitkin",12,12,2750,6275,77,9102,0.00313324272161993
"267","Prowers",13,13,3382,1306,26,4714,0.00162273194789237
"268","Pueblo",133,133,30665,34654,413,65732,0.0226273687736235
"269","Rio Blanco",7,7,2370,560,17,2947,0.00101446564498066
"270","Rio Grande",15,15,3413,1970,46,5429,0.0018688612102477
"271","Routt",22,22,5109,6270,86,11465,0.00394667411594952
"272","Saguache",9,9,1134,1558,18,2710,0.000932881539836301
"273","San Juan",1,1,216,253,10,479,0.000164889393941545
"274","San Miguel",6,6,1070,2857,30,3957,0.00136214474285323
"275","Sedgwick",6,6,947,368,7,1322,0.000455080957809443
"276","Summit",19,19,5320,8032,113,13465,0.00463514757708332
"277","Teller",16,16,7868,3447,87,11402,0.0039249872019238
"278","Washington",6,6,2019,450,12,2481,0.000854051328536481
"279","Weld",101,101,55213,31623,495,87331,0.030062537917138
"280","Yuma",15,15,3423,1044,17,4484,0.00154355749986198
"281","Andover",1,1,793,972,22,1787,0.000615151037523051
"282","Ansonia",7,7,3272,4065,80,7417,0.0025532038306147
"283","Ashford",1,1,933,1307,31,2271,0.000781761615117431
"284","Avon",2,2,5141,4925,77,10143,0.00349159315814007
"285","Barkhamsted",1,1,995,1124,30,2149,0.00073976473398827
"286","Beacon Falls",1,1,1634,1206,35,2875,0.000989680600379839
"287","Berlin",5,5,5018,5559,73,10650,0.00366612118053749
"288","Bethany",1,1,1618,1617,39,3274,0.00112703105587603
"289","Bethel",5,5,4928,4486,79,9493,0.00326783928327159
"290","Bethlehem",1,1,1337,922,31,2290,0.000788302112998203
"291","Bloomfield",6,6,2337,8156,41,10534,0.00362618971979173
"292","Bolton",1,1,1459,1542,30,3031,0.00104338153034828
"293","Bozrah",1,1,646,723,13,1382,0.000475735161643457
"294","Branford",7,7,6285,8335,109,14729,0.00507026280451988
"295","Bridgeport",25,25,10326,26280,140,36746,0.0126493229014113
"296","Bridgewater",1,1,628,521,15,1164,0.000400691554379872
"297","Bristol",10,10,10611,14188,179,24978,0.00859834505610005
"298","Brookfield",2,2,5162,3618,59,8839,0.00304270846148084
"299","Brooklyn",1,1,1628,1668,49,3345,0.00115147186374628
"300","Burlington",1,1,2539,2501,33,5073,0.00174631293416589
"301","Canaan",1,1,219,378,17,614,0.000211361352568077
"302","Canterbury",1,1,1370,1193,47,2610,0.000898457866779611
"303","Canton",1,1,2502,3003,54,5559,0.0019136119852214
"304","Chaplin",1,1,505,590,27,1122,0.000386233611696063
"305","Cheshire",7,7,7583,7283,114,14980,0.00515666622389217
"306","Chester",1,1,796,1375,26,2197,0.000756288097055481
"307","Clinton",1,1,3160,3332,42,6534,0.00224924279752413
"308","Colchester",1,1,3418,4081,67,7566,0.00260449510346917
"309","Colebrook",1,1,429,458,20,907,0.000312222714624179
"310","Columbia",1,1,1272,1771,41,3084,0.00106162607706832
"311","Cornwall",1,1,296,625,13,934,0.000321517106349485
"312","Coventry",2,2,2641,3588,85,6314,0.00217351071679941
"313","Cromwell",1,1,3226,4126,68,7420,0.0025542365408064
"314","Danbury",7,7,11327,12178,151,23656,0.0081432640982906
"315","Darien",6,6,6888,4057,54,10999,0.00378625979950534
"316","Deep River",1,1,1007,1548,30,2585,0.000889851948515438
"317","Derby",2,2,2600,2582,40,5222,0.00179760420702036
"318","Durham",2,2,2024,2017,53,4094,0.00140930517494089
"319","East Granby",2,2,1375,1352,21,2748,0.000945962535597843
"320","East Haddam",1,1,2009,2607,53,4669,0.00160724129501686
"321","East Hampton",1,1,2941,3360,63,6364,0.00219072255332776
"322","East Hartford",7,7,6320,11993,160,18473,0.00635908512376236
"323","East Haven",7,7,5427,6196,94,11717,0.00403342177205237
"324","East Lyme",3,3,4030,5306,84,9420,0.0032427100019402
"325","East Windsor",2,2,2074,2571,44,4689,0.0016141260296282
"326","Eastford",1,1,513,416,11,940,0.000323582526732887
"327","Easton",1,1,2462,2002,24,4488,0.00154493444678425
"328","Ellington",2,2,3700,3467,67,7234,0.00249020850892096
"329","Enfield",9,9,8669,10826,166,19661,0.00676803835967583
"330","Essex",2,2,1852,2201,33,4086,0.00140655128109636
"331","Fairfield",10,10,14694,15047,204,29945,0.0103081688968258
"332","Farmington",4,4,6294,7205,93,13592,0.00467886564186531
"333","Franklin",1,1,540,513,8,1061,0.000365235171131482
"334","Glastonbury",9,9,8094,8986,149,17229,0.00593085463093713
"335","Goshen",1,1,954,715,15,1684,0.000579694654274661
"336","Granby",2,2,3108,3015,61,6184,0.00212875994182571
"337","Greenwich",21,21,14086,12363,147,26596,0.00915532008615729
"338","Griswold",2,2,2143,2599,51,4793,0.00164992664960715
"339","Groton",8,8,6464,8006,139,14609,0.00502895439685185
"340","Guilford",4,4,5554,7294,95,12943,0.0044554560037274
"341","Haddam",2,2,2039,2354,37,4430,0.00152496871641137
"342","Hamden",11,11,9990,17774,199,27963,0.00962589169684224
"343","Hampton",1,1,445,608,13,1066,0.000366956354784316
"344","Hartford",23,23,4623,22595,168,27386,0.00942726710330514
"345","Hartland",1,1,708,435,19,1162,0.000400003080918739
"346","Harwinton",2,2,1762,1308,47,3117,0.00107298588917703
"347","Hebron",1,1,2426,2623,52,5101,0.00175595156262176
"348","Kent",1,1,713,1038,16,1767,0.000608266302911714
"349","Killingly",8,8,2993,3341,92,6426,0.0022120652306229
"350","Killingworth",1,1,1865,1895,35,3795,0.00130637839250139
"351","Lebanon",1,1,1799,1944,42,3785,0.00130293602519572
"352","Ledyard",2,2,3580,3438,77,7095,0.00244235960337216
"353","Lisbon",1,1,915,1086,20,2021,0.000695702432475706
"354","Litchfield",4,4,2375,2164,44,4583,0.00157763693618811
"355","Lyme",1,1,594,850,23,1467,0.000504995283741643
"356","Madison",2,2,5377,4864,76,10317,0.00355149034925871
"357","Manchester",10,10,9948,15268,241,25457,0.00876323445004159
"358","Mansfield",3,3,2171,6169,162,8502,0.00292670068327979
"359","Marlborough",1,1,1710,1850,42,3602,0.00123994070350198
"360","Meriden",17,17,8845,13368,203,22416,0.00771641055238765
"361","Middlebury",1,1,2423,1584,43,4050,0.00139415875879595
"362","Middlefield",1,1,1099,1478,25,2602,0.000895703972935076
"363","Middletown",14,14,5955,11854,0,17809,0.00613051193466593
"364","Milford",10,10,12880,13145,261,26286,0.00904860669968155
"365","Monroe",4,4,6195,4349,62,10606,0.00365097476439255
"366","Montville",6,6,3527,4259,84,7870,0.00270914306956151
"367","Morris",1,1,783,581,18,1382,0.000475735161643457
"368","Naugatuck",10,10,6838,5745,123,12706,0.00437387189858304
"369","New Britain",17,17,6012,12988,145,19145,0.00659041220670331
"370","New Canaan",3,3,6618,4180,56,10854,0.00373634547357314
"371","New Fairfield",2,2,4072,2687,51,6810,0.00234425213516059
"372","New Hartford",2,2,1950,1874,42,3866,0.00133081920037164
"373","New Haven",42,42,7163,30926,341,38430,0.013229017555686
"374","New London",7,7,2381,5984,68,8433,0.00290294834887067
"375","New Milford",7,7,7174,5854,129,13157,0.00452912266406871
"376","Newington",8,8,6252,9365,127,15744,0.00541966308604528
"377","Newtown",4,4,7739,6540,103,14382,0.00495081265901316
"378","Norfolk",1,1,407,555,11,973,0.000334942338841594
"379","North Branford",2,2,3556,3439,60,7055,0.00242859013414948
"380","North Canaan",1,1,708,796,2,1506,0.000518420516233752
"381","North Haven",5,5,6471,6359,96,12926,0.00444960397930776
"382","North Stonington",1,1,1360,1407,32,2799,0.000963518608856755
"383","Norwalk",14,14,14201,20615,246,35062,0.0120696282471367
"384","Norwich",10,10,4841,8223,163,13227,0.0045532192352084
"385","Old Lyme",1,1,1896,2394,53,4343,0.00149502012085205
"386","Old Saybrook",2,2,2828,3119,51,5998,0.00206473190994027
"387","Orange",2,2,4390,3774,60,8224,0.00283100287218219
"388","Oxford",1,1,3628,2286,59,5973,0.0020561259916761
"389","Plainfield",4,4,2844,3103,89,6036,0.00207781290570181
"390","Plainville",4,4,3407,4403,72,7882,0.00271327391032831
"391","Plymouth",2,2,2773,2737,56,5566,0.00191602164233537
"392","Pomfret",1,1,1087,1098,27,2212,0.000761451648013984
"393","Portland",1,1,2105,2930,50,5085,0.00175044377493269
"394","Preston",1,1,1184,1297,37,2518,0.000866788087567456
"395","Prospect",2,2,2983,1804,50,4837,0.0016650730657521
"396","Putnam",2,2,1738,1825,37,3600,0.00123925223004084
"397","Redding",2,2,2589,2797,34,5420,0.0018657630796726
"398","Ridgefield",3,3,6567,5643,77,12287,0.00422963670847551
"399","Rocky Hill",3,3,4130,5485,74,9689,0.0033353096824627
"400","Roxbury",1,1,715,727,14,1456,0.000501208679705407
"401","Salem",1,1,986,1125,28,2139,0.0007363223666826
"402","Salisbury",1,1,730,1600,23,2353,0.000809989027023917
"403","Scotland",1,1,430,430,8,868,0.00029879748213207
"404","Seymour",3,3,4035,3202,99,7336,0.00252532065543878
"405","Sharon",1,1,649,897,15,1561,0.000537353536414932
"406","Shelton",6,6,11137,8247,149,19533,0.00672397605816327
"407","Sherman",1,1,1121,958,21,2100,0.000722897134190491
"408","Simsbury",4,4,6753,6799,111,13663,0.00470330644973556
"409","Somers",1,1,2734,2114,37,4885,0.00168159642881931
"410","South Windsor",7,7,6174,7643,106,13923,0.00479280799968296
"411","Southbury",5,5,6526,4828,97,11451,0.00394185480172158
"412","Southington",12,12,10179,11044,136,21359,0.00735255232817843
"413","Sprague",1,1,631,717,15,1363,0.000469194663762686
"414","Stafford",3,3,2795,3234,65,6094,0.00209777863607469
"415","Stamford",23,23,18856,27575,213,46644,0.0160565780605625
"416","Sterling",1,1,707,643,12,1362,0.000468850427032119
"417","Stonington",5,5,3948,5728,100,9776,0.00336525827802202
"418","Stratford",13,13,11945,12057,194,24196,0.00832915193279673
"419","Suffield",1,1,3525,3224,61,6810,0.00234425213516059
"420","Thomaston",1,1,2272,1582,34,3888,0.00133839240844411
"421","Thompson",4,4,2126,2116,39,4281,0.0014736774435569
"422","Tolland",2,2,3976,4031,70,8077,0.00278040007278886
"423","Torrington",8,8,8175,7362,184,15721,0.00541174564124224
"424","Trumbull",10,10,10789,8656,128,19573,0.00673774552738595
"425","Union",1,1,245,222,5,472,0.000162479736827577
"426","Vernon",6,6,5765,7695,110,13570,0.00467129243379284
"427","Voluntown",1,1,633,564,19,1216,0.000418591864369351
"428","Wallingford",9,9,9956,11644,220,21820,0.00751124546096977
"429","Warren",1,1,427,342,10,779,0.000268160413111616
"430","Washington",1,1,941,1242,17,2200,0.000757320807247181
"431","Waterbury",23,23,15052,14735,247,30034,0.0103388059658463
"432","Waterford",4,4,4405,5798,87,10290,0.00354219595753341
"433","Watertown",4,4,6954,4146,121,11221,0.00386268035369119
"434","West Hartford",20,20,11641,21612,216,33469,0.0115212591353436
"435","West Haven",12,12,7840,13047,176,21063,0.00725065825593063
"436","Westbrook",2,2,1787,1908,30,3725,0.0012822818213617
"437","Weston",2,2,2410,3136,28,5574,0.0019187755361799
"438","Westport",6,6,6063,9115,63,15241,0.00524651201057013
"439","Wethersfield",10,10,6517,8227,113,14857,0.00511432510603244
"440","Willington",1,1,1265,1710,36,3011,0.00103649679573694
"441","Wilton",3,3,5422,4823,51,10296,0.00354426137791681
"442","Winchester",1,1,2532,2577,89,5198,0.00178934252548675
"443","Windham",5,5,2770,5134,100,8004,0.00275527079145747
"444","Windsor",7,7,5253,9297,139,14689,0.0050564933352972
"445","Windsor Locks",2,2,2651,3200,55,5906,0.00203306213072812
"446","Wolcott",3,3,5213,2974,84,8271,0.00284718199851884
"447","Woodbridge",1,1,2290,3070,40,5400,0.00185887834506126
"448","Woodbury",2,2,3260,2519,41,5820,0.00200345777189936
"449","Woodstock",1,1,2229,1996,34,4259,0.00146610423548443
"450","District of Columbia",142,142,19007,183876,1318,204201,0.0702934846184917
"451","Kent",66,66,31555,23854,362,55771,0.0191984267004466
"452","New Castle",305,305,92973,145935,1335,240243,0.0827004648615839
"453","Sussex",64,64,47003,30098,454,77555,0.026697279639116
"454","Alachua",69,69,47615,62348,557,110520,0.0380450434622539
"455","Baker",9,9,7738,2180,22,9940,0.00342171310183499
"456","Bay",59,59,53388,21058,359,74805,0.025750628630057
"457","Bradford",22,22,7553,3244,28,10825,0.0037263626083867
"458","Brevard",221,221,152838,110153,1196,264187,0.0909428691382778
"459","Broward",1044,1044,243699,452360,3806,699865,0.240919239438204
"460","Calhoun",15,15,3780,2116,38,5934,0.00204270075918399
"461","Charlotte",80,80,44402,34227,555,79184,0.0272580412732095
"462","Citrus",41,41,39498,29274,452,69224,0.0238294434367631
"463","Clay",62,62,61881,18905,258,81044,0.0278983215920639
"464","Collier",93,93,83485,43713,595,127793,0.0439910445093359
"465","Columbia",25,25,16753,8029,109,24891,0.00856839646054072
"466","DeSoto",17,17,5512,3910,48,9470,0.00325992183846855
"467","Dixie",11,11,4433,1959,29,6421,0.00221034404697007
"468","Duval",285,285,219251,158121,1218,378590,0.130324583825323
"469","Escambia",91,91,93367,48243,545,142155,0.0489349724337378
"470","Flagler",34,34,19632,18574,181,38387,0.0132142153762716
"471","Franklin",10,10,3472,2400,37,5909,0.00203409484091982
"472","Gadsden",26,26,6253,14629,54,20936,0.00720694019114863
"473","Gilchrist",12,12,4934,2016,32,6982,0.0024034608528181
"474","Glades",13,13,2443,1718,16,4177,0.00143787682357794
"475","Gulf",16,16,4794,2398,40,7232,0.00248952003545983
"476","Hamilton",10,10,2792,2260,16,5068,0.00174459175051305
"477","Hardee",12,12,5047,2148,39,7234,0.00249020850892096
"478","Hendry",26,26,5756,3960,24,9740,0.00335286575572161
"479","Hernando",56,56,41847,36521,508,78876,0.0271520163601949
"480","Highlands",27,27,25874,15346,188,41408,0.0142541545393142
"481","Hillsborough",360,360,244606,213413,1947,459966,0.158337192011935
"482","Holmes",18,18,6410,1810,42,8262,0.00284408386794373
"483","Indian River",57,57,36869,23932,292,61093,0.0210304545805237
"484","Jackson",28,28,12115,7552,74,19741,0.00679557729812119
"485","Jefferson",15,15,3298,4134,27,7459,0.00256766177329851
"486","Lafayette",6,6,2460,845,11,3316,0.00114148899855984
"487","Lake",102,102,74382,48216,659,123257,0.0424295866994845
"488","Lee",175,175,144414,94365,1394,240173,0.0826763682904442
"489","Leon",116,116,51594,83830,476,135900,0.0467817716840418
"490","Levy",20,20,10408,6073,97,16578,0.00570675651933808
"491","Liberty",10,10,1927,1070,14,3011,0.00103649679573694
"492","Madison",11,11,4196,4048,41,8285,0.00285200131274677
"493","Manatee",136,136,81272,61228,681,143181,0.0492881593192994
"494","Marion",143,143,81267,57255,649,139171,0.0479077700297261
"495","Martin",51,51,41350,30197,418,71965,0.024772996315247
"496","Miami-Dade",856,856,358613,406099,1999,766711,0.263930087929679
"497","Monroe",33,33,19462,19649,283,39394,0.0135608617639525
"498","Nassau",24,24,23732,8545,183,32460,0.0111739242742016
"499","Okaloosa",54,54,69654,19358,372,89384,0.0307692559249918
"500","Okeechobee",18,18,6987,5151,32,12170,0.00418936101099918
"501","Orange",272,272,192390,193217,1141,386748,0.133132867073288
"502","Osceola",93,93,43108,38617,280,82005,0.0282291330901387
"503","Palm Beach",695,695,211894,327698,1565,541157,0.186286116403392
"504","Pasco",170,170,103198,84731,1440,189369,0.0651877654307234
"505","Pinellas",377,377,225627,225367,2401,453395,0.15607521245538
"506","Polk",161,161,123532,85983,799,210314,0.0723978037524471
"507","Putnam",55,55,18305,12409,136,30850,0.0106197031379889
"508","Santa Rosa",43,43,51988,14637,295,66920,0.023036322009537
"509","Sarasota",156,156,104630,88382,1259,194271,0.0668752138839624
"510","Seminole",126,126,108126,76938,570,185634,0.063902041242056
"511","St Johns",68,68,59178,26389,403,85970,0.0295940317268365
"512","St Lucie",75,75,47575,51816,436,99827,0.034364120102302
"513","Sumter",42,42,19795,11584,248,31627,0.0108871750776394
"514","Suwannee",19,19,11153,4521,85,15759,0.00542482663700379
"515","Taylor",14,14,5466,3049,45,8560,0.00294666641365267
"516","Union",11,11,3396,1251,16,4663,0.00160517587463346
"517","Volusia",179,179,111544,115319,911,227774,0.0784081770681452
"518","Wakulla",12,12,6777,4896,47,11720,0.00403445448224408
"519","Walton",33,33,17553,6213,119,23885,0.00822209430959042
"520","Washington",21,21,7368,2912,53,10333,0.00355699813694778
"521","Appling",18,18,4494,1848,0,6342,0.00218314934525528
"522","Atkinson",5,5,1666,799,0,2465,0.00084854354084741
"523","Bacon",6,6,2853,930,0,3783,0.00130224755173459
"524","Baker",6,6,821,936,0,1757,0.000604823935606044
"525","Baldwin",15,15,7707,6774,0,14481,0.00498489209533929
"526","Banks",14,14,4410,1149,0,5559,0.0019136119852214
"527","Barrow",14,14,13022,3937,0,16959,0.00583791071368407
"528","Bartow",20,20,22302,7737,0,30039,0.0103405271494991
"529","Ben Hill",6,6,3331,2180,0,5511,0.00189708862215419
"530","Berrien",10,10,3914,1637,0,5551,0.00191085809137687
"531","Bibb",51,51,28079,29268,0,57347,0.0197409437878201
"532","Bleckley",2,2,3167,1281,0,4448,0.00153116497756157
"533","Brantley",10,10,4332,1258,0,5590,0.00192428332386897
"534","Brooks",10,10,2722,2053,0,4775,0.00164373038845695
"535","Bryan",10,10,7453,2632,0,10085,0.00347162742776719
"536","Bulloch",15,15,12245,6832,0,19077,0.00656700410902476
"537","Burke",16,16,4232,4213,0,8445,0.00290707918963748
"538","Butts",11,11,5119,2570,0,7689,0.0026468362213289
"539","Calhoun",6,6,890,1118,0,2008,0.000691227354978337
"540","Camden",15,15,9471,4629,0,14100,0.0048537379009933
"541","Candler",3,3,2048,1096,0,3144,0.00108228028090234
"542","Carroll",33,33,24813,10203,0,35016,0.0120537933575306
"543","Catoosa",13,13,16402,5805,0,22207,0.00764446507569916
"544","Charlton",10,10,2310,1064,0,3374,0.00116145472893272
"545","Chatham",109,109,41384,42910,0,84294,0.0290170909664063
"546","Chattahoochee",2,2,902,773,0,1675,0.000576596523699559
"547","Chattooga",14,14,4964,2791,0,7755,0.00266955584554631
"548","Cherokee",45,45,55447,14090,0,69537,0.0239371895334306
"549","Clarke",25,25,15042,21707,0,36749,0.012650355611603
"550","Clay",6,6,509,798,0,1307,0.000449917406850939
"551","Clayton",51,51,19808,50445,0,70253,0.0241836630325165
"552","Clinch",6,6,1501,750,0,2251,0.000774876880506093
"553","Cobb",206,206,173206,103720,0,276926,0.0953281008489695
"554","Coffee",7,7,8304,3977,0,12281,0.00422757128809211
"555","Colquitt",20,20,8296,3378,0,11674,0.004018619592638
"556","Columbia",44,44,35546,11441,0,46987,0.016174651259147
"557","Cook",9,9,3065,1733,0,4798,0.00165164783325999
"558","Coweta",29,29,31649,10630,0,42279,0.014553984731638
"559","Crawford",7,7,2827,1551,0,4378,0.00150706840642189
"560","Crisp",7,7,3865,2357,0,6222,0.00214184093758726
"561","Dade",8,8,4367,1822,0,6189,0.00213048112547855
"562","Dawson",9,9,6649,1407,0,8056,0.00277317110144695
"563","Decatur",15,15,5346,3573,0,8919,0.00307024739992619
"564","DeKalb",194,194,73527,200632,0,274159,0.0943755978154909
"565","Dodge",17,17,4584,2384,0,6968,0.00239864153859016
"566","Dooly",6,6,1853,1973,0,3826,0.00131704973114896
"567","Dougherty",32,32,13709,19795,0,33504,0.0115333074209134
"568","Douglas",23,23,25835,15986,0,41821,0.0143963243090384
"569","Early",12,12,2494,1698,0,4192,0.00144304037453645
"570","Echols",2,2,757,231,0,988,0.000340105889800098
"571","Effingham",22,22,12451,3597,0,16048,0.00552431105213762
"572","Elbert",12,12,4618,2979,0,7597,0.00261516644211674
"573","Emanuel",15,15,4665,2774,0,7439,0.00256077703868717
"574","Evans",11,11,2291,1213,0,3504,0.00120620550390642
"575","Fannin",12,12,6859,2727,0,9586,0.00329985329921431
"576","Fayette",37,37,37322,14862,0,52184,0.0179636495479031
"577","Floyd",26,26,21338,10010,0,31348,0.0107911330298112
"578","Forsyth",31,31,47254,9198,0,56452,0.0194328519139627
"579","Franklin",14,14,5216,2245,0,7461,0.00256835024675965
"580","Fulton",327,327,123670,189899,0,313569,0.107941967367132
"581","Gilmer",14,14,7414,2510,0,9924,0.00341620531414592
"582","Glascock",3,3,1016,250,0,1266,0.000435803700897696
"583","Glynn",25,25,18602,8960,0,27562,0.00948785276788492
"584","Gordon",15,15,11671,4028,0,15699,0.00540417243316977
"585","Grady",14,14,5065,3092,0,8157,0.00280793901123421
"586","Greene",9,9,4069,2774,0,6843,0.0023556119472693
"587","Gwinnett",149,149,160013,81334,0,241347,0.0830805022121298
"588","Habersham",15,15,10428,2748,0,13176,0.00453566316194948
"589","Hall",40,40,38861,10506,0,49367,0.0169939346778962
"590","Hancock",8,8,822,2715,0,3537,0.00121756531601513
"591","Haralson",13,13,7695,2431,0,10126,0.00348574113372044
"592","Harris",13,13,8874,3400,0,12274,0.00422516163097814
"593","Hart",8,8,5499,3476,0,8975,0.00308952465683793
"594","Heard",10,10,2788,1148,0,3936,0.00135491577151132
"595","Henry",32,32,42748,21091,0,63839,0.0219757286426604
"596","Houston",29,29,29848,15042,0,44890,0.0154527868351482
"597","Irwin",9,9,2347,1051,0,3398,0.00116971641046633
"598","Jackson",15,15,12605,3466,0,16071,0.00553222849694066
"599","Jasper",8,8,3157,1558,0,4715,0.00162307618462294
"600","Jeff Davis",10,10,3549,1277,0,4826,0.00166128646171586
"601","Jefferson",9,9,3066,3447,0,6513,0.00224201382618222
"602","Jenkins",6,6,1896,1493,0,3389,0.00116661827989123
"603","Johnson",8,8,2279,1263,0,3542,0.00121928649966796
"604","Jones",12,12,6939,3854,0,10793,0.00371534703300856
"605","Lamar",7,7,4027,2432,0,6459,0.00222342504273161
"606","Lanier",4,4,1641,931,0,2572,0.000885376871018069
"607","Laurens",21,21,10882,6280,0,17162,0.00590779076998915
"608","Lee",11,11,8201,2182,0,10383,0.00357420997347613
"609","Liberty",14,13,6127,6616,0,12743,0.00438660865761402
"610","Lincoln",8,8,2309,1337,0,3646,0.00125508711964692
"611","Long",6,6,1992,1029,0,3021,0.00103993916304261
"612","Lowndes",38,38,18942,12491,0,31433,0.0108203931519094
"613","Lumpkin",16,16,6690,2091,0,8781,0.00302274273110795
"614","Macon",6,6,1851,2906,0,4757,0.00163753412730675
"615","Madison",13,13,7253,2527,0,9780,0.00336663522494429
"616","Marion",8,8,1670,1275,0,2945,0.00101377717151952
"617","McDuffie",11,11,4755,2858,0,7613,0.00262067422980581
"618","McIntosh",7,7,2837,2523,0,5360,0.00184510887583859
"619","Meriwether",15,15,4401,3709,0,8110,0.00279175988489756
"620","Miller",2,2,1688,736,0,2424,0.000834429834894167
"621","Mitchell",12,12,3885,3360,0,7245,0.0024939951129572
"622","Monroe",15,15,6522,3216,0,9738,0.00335217728226048
"623","Montgomery",8,8,2150,1007,0,3157,0.00108675535839971
"624","Morgan",11,11,4902,2304,0,7206,0.00248056988046509
"625","Murray",8,8,7745,2899,0,10644,0.00366405576015409
"626","Muscogee",49,49,30544,32727,0,63271,0.0217802021796984
"627","Newton",24,24,18094,10939,0,29033,0.00999422499854883
"628","Oconee",15,15,10273,3785,0,14058,0.00483927995830949
"629","Oglethorpe",11,11,3686,1899,0,5585,0.00192256214021614
"630","Paulding",26,26,30830,9414,0,40244,0.0138534629849343
"631","Peach",8,8,4554,3960,0,8514,0.00293083152404659
"632","Pickens",13,13,7897,2353,0,10250,0.00352842648831073
"633","Pierce",9,9,4677,1233,0,5910,0.00203443907765038
"634","Pike",9,9,5193,1506,0,6699,0.00230604185806767
"635","Polk",12,12,8467,3868,0,12335,0.00424616007154272
"636","Pulaski",4,4,2202,1294,0,3496,0.00120345161006188
"637","Putnam",10,10,5187,2876,0,8063,0.00277558075856092
"638","Quitman",3,3,409,543,0,952,0.000327713367499689
"639","Rabun",10,10,4649,1918,0,6567,0.00226060260963284
"640","Randolph",10,10,1418,1612,0,3030,0.00104303729361771
"641","Richmond",71,71,29764,39262,0,69026,0.0237612845641109
"642","Rockdale",17,17,18855,12134,0,30989,0.0106675520435377
"643","Schley",2,2,1063,464,0,1527,0.000525649487575657
"644","Screven",13,13,3360,2534,0,5894,0.00202893128996131
"645","Seminole",7,7,1975,1278,0,3253,0.00111980208453413
"646","Spalding",21,21,13458,7457,0,20915,0.00719971121980673
"647","Stephens",9,9,6904,2714,0,9618,0.00331086887459245
"648","Stewart",6,6,797,1220,0,2017,0.000694325485553439
"649","Sumter",11,11,5682,5555,0,11237,0.00386818814138026
"650","Talbot",9,9,1102,1830,0,2932,0.00100930209402215
"651","Taliaferro",3,3,335,612,0,947,0.000325992183846855
"652","Tattnall",16,16,4657,1787,0,6444,0.00221826149177311
"653","Taylor",7,7,1912,1458,0,3370,0.00116007778201046
"654","Telfair",7,7,2171,1590,0,3761,0.00129467434366211
"655","Terrell",8,8,1859,1950,0,3809,0.00131119770672932
"656","Thomas",21,21,9659,5997,0,15656,0.0053893702537554
"657","Tift",13,13,8616,3862,0,12478,0.00429538592401379
"658","Toombs",15,15,6192,2561,0,8753,0.00301310410265208
"659","Towns",5,5,3819,1430,0,5249,0.00180689859874566
"660","Treutlen",7,7,1688,1052,0,2740,0.000943208641753308
"661","Troup",17,17,14180,7625,0,21805,0.00750608191001127
"662","Turner",4,4,1815,1135,0,2950,0.00101549835517236
"663","Twiggs",6,6,2109,2219,0,4328,0.00148985656989355
"664","Union",12,12,6843,2325,0,9168,0.00315596234583735
"665","Upson",11,11,6632,3423,0,10055,0.00346130032585019
"666","Walker",19,19,15340,5986,0,21326,0.00734119251606972
"667","Walton",20,20,21585,5885,0,27470,0.00945618298867276
"668","Ware",13,13,6789,2832,0,9621,0.00331190158478415
"669","Warren",7,7,1121,1359,0,2480,0.000853707091805914
"670","Washington",9,9,4081,3733,0,7814,0.00268986581264976
"671","Wayne",16,16,6817,2683,0,9500,0.00327024894038556
"672","Webster",5,5,485,515,0,1000,0.000344236730566901
"673","Wheeler",3,3,1192,847,0,2039,0.00070189869362591
"674","White",11,11,7403,2016,0,9419,0.00324236576520964
"675","Whitfield",24,24,19295,6933,0,26228,0.00902864096930867
"676","Wilcox",7,7,1705,902,0,2607,0.00089742515658791
"677","Wilkes",8,8,2488,2028,0,4516,0.00155457307524012
"678","Wilkinson",10,10,2257,2233,0,4490,0.00154562292024538
"679","Worth",17,17,5103,2217,0,7320,0.00251981286774971
"680","Hawaii",71,71,22032,35114,0,57146,0.0196717522049761
"681","Honolulu",217,217,144151,152491,0,296642,0.102115072228827
"682","Kauai",21,21,9740,14915,0,24655,0.00848715659212694
"683","Maui",44,44,18186,28798,0,46984,0.0161736185489553
"684","Adair",10,10,2393,1833,14,4240,0.00145956373760366
"685","Adams",12,12,1313,973,11,2297,0.000790711770112171
"686","Allamakee",23,23,3523,3437,35,6995,0.00240793593031547
"687","Appanoose",14,14,3328,3047,23,6398,0.00220242660216703
"688","Audubon",7,7,1951,1599,13,3563,0.00122651547100987
"689","Benton",20,20,6634,6690,48,13372,0.0046031335611406
"690","Black Hawk",64,64,27825,34614,245,62684,0.0215781352188556
"691","Boone",17,17,6809,6956,42,13807,0.0047528765389372
"692","Bremer",17,17,6662,6022,56,12740,0.00438557594742231
"693","Buchanan",16,16,4785,5555,29,10369,0.00356939065924819
"694","Buena Vista",19,19,4846,3497,43,8386,0.00288676922253403
"695","Butler",13,13,4413,3001,26,7440,0.00256112127541774
"696","Calhoun",15,15,3240,2232,7,5479,0.00188607304677605
"697","Carroll",16,16,5760,4688,42,10490,0.00361104330364679
"698","Cass",18,18,4780,2666,37,7483,0.00257592345483212
"699","Cedar",14,14,4831,4692,40,9563,0.00329193585441127
"700","Cerro Gordo",27,27,10917,13247,89,24253,0.00834877342643904
"701","Cherokee",12,12,3750,2977,28,6755,0.00232531911497941
"702","Chickasaw",18,18,3030,3694,26,6750,0.00232359793132658
"703","Clarke",8,8,2188,2301,16,4505,0.00155078647120389
"704","Clay",14,14,4878,3499,55,8432,0.00290260411214011
"705","Clayton",26,26,4302,4715,51,9068,0.00312153867278066
"706","Clinton",31,31,10749,13742,99,24590,0.00846478120464009
"707","Crawford",17,17,3946,3213,45,7204,0.00247988140700395
"708","Dallas",28,28,15094,10825,86,26005,0.00895187617839225
"709","Davis",9,9,2142,1726,14,3882,0.00133632698806071
"710","Decatur",14,14,2083,1854,22,3959,0.00136283321631436
"711","Delaware",17,17,4894,4203,41,9138,0.00314563524392034
"712","Des Moines",20,20,8156,12296,94,20546,0.00707268786622754
"713","Dickinson",16,16,5319,4115,43,9477,0.00326233149558252
"714","Dubuque",40,40,19934,26265,196,46395,0.0159708631146514
"715","Emmet",12,12,2686,2395,41,5122,0.00176318053396367
"716","Fayette",29,29,5106,5156,43,10305,0.00354735950849191
"717","Floyd",14,14,3716,4314,33,8063,0.00277558075856092
"718","Franklin",19,19,3124,2333,11,5468,0.00188228644273981
"719","Fremont",13,13,2348,1500,21,3869,0.00133185191056334
"720","Greene",15,15,2609,2449,8,5066,0.00174390327705192
"721","Grundy",8,8,4411,2373,13,6797,0.00233977705766322
"722","Guthrie",19,19,3314,2591,31,5936,0.00204338923264512
"723","Hamilton",14,14,4345,3866,32,8243,0.00283754337006296
"724","Hancock",11,11,3352,2471,30,5853,0.00201481758400807
"725","Hardin",13,13,4853,3989,28,8870,0.00305337980012841
"726","Harrison",14,14,4659,2895,41,7595,0.00261447796865561
"727","Henry",19,19,5199,4097,49,9345,0.00321689224714769
"728","Howard",11,11,2020,2612,29,4661,0.00160448740117232
"729","Humboldt",12,12,3146,2133,24,5303,0.00182548738219627
"730","Ida",9,9,2335,1411,6,3752,0.00129157621308701
"731","Iowa",12,12,4530,3820,37,8387,0.0028871134592646
"732","Jackson",17,17,4231,5609,61,9901,0.00340828786934288
"733","Jasper",22,22,9396,10346,61,19803,0.00681691997541633
"734","Jefferson",13,13,3600,4388,40,8028,0.00276353247299108
"735","Johnson",58,58,22287,40431,295,63013,0.0216913891032121
"736","Jones",18,18,4809,5007,53,9869,0.00339727229396474
"737","Keokuk",17,17,3110,2285,30,5425,0.00186748426332544
"738","Kossuth",23,23,5022,4115,47,9184,0.00316147013352642
"739","Lee",24,24,7303,9701,85,17089,0.00588266148865777
"740","Linn",87,87,49243,59995,420,109658,0.0377483114005052
"741","Louisa",11,11,2535,2239,19,4793,0.00164992664960715
"742","Lucas",9,9,2534,1983,0,4517,0.00155491731197069
"743","Lyon",9,9,4732,1295,30,6057,0.00208504187704372
"744","Madison",11,11,4519,3346,39,7904,0.00272084711840078
"745","Mahaska",18,18,6826,3763,39,10628,0.00365854797246502
"746","Marion",22,22,9971,6564,69,16604,0.00571570667433282
"747","Marshall",20,20,9481,9316,75,18872,0.00649643557925855
"748","Mills",12,12,4538,2296,48,6882,0.00236903717976141
"749","Mitchell",15,15,2629,2758,31,5418,0.00186507460621147
"750","Monona",17,17,2561,2387,25,4973,0.0017118892611092
"751","Monroe",11,11,2066,1854,13,3933,0.00135388306131962
"752","Montgomery",14,14,3560,1862,34,5456,0.00187815560197301
"753","Muscatine",28,28,8936,9397,65,18398,0.00633326736896984
"754","OBrien",10,10,5318,2321,36,7675,0.00264201690710096
"755","Osceola",10,10,2286,932,15,3233,0.00111291734992279
"756","Page",13,13,5214,2199,34,7447,0.00256353093253171
"757","Palo Alto",19,19,2665,2479,19,5163,0.00177729423991691
"758","Plymouth",14,14,7778,4251,53,12082,0.00415906817870929
"759","Pocahontas",12,12,2440,1822,18,4280,0.00147333320682633
"760","Polk",184,184,95056,103774,554,199384,0.0686352962873509
"761","Pottawattamie",47,47,23521,16410,180,40111,0.013807679499769
"762","Poweshiek",22,22,4933,4999,26,9958,0.0034279093629852
"763","Ringgold",9,9,1465,1284,7,2756,0.000948716429442378
"764","Sac",10,10,3118,2208,19,5345,0.00183994532488008
"765","Scott",64,64,39750,41738,282,81770,0.0281482374584555
"766","Shelby",17,17,4240,2333,31,6604,0.00227333936866381
"767","Sioux",22,22,14167,2247,41,16455,0.00566441540147835
"768","Story",44,44,20716,23082,218,44016,0.0151519239326327
"769","Tama",17,17,4434,4471,25,8930,0.00307403400396242
"770","Taylor",10,10,1900,1245,11,3156,0.00108641112166914
"771","Union",10,10,3143,2738,32,5913,0.00203547178784208
"772","Van Buren",10,10,2204,1556,19,3779,0.00130087060481232
"773","Wapello",25,25,7234,8996,96,16326,0.00562000886323522
"774","Warren",26,26,12130,10699,70,22899,0.00788267689325146
"775","Washington",14,14,5955,4540,58,10553,0.0036327302176725
"776","Wayne",11,11,1724,1373,6,3103,0.00106816657494909
"777","Webster",34,34,8906,9468,53,18427,0.00634325023415628
"778","Winnebago",17,17,3168,2691,28,5887,0.00202652163284734
"779","Winneshiek",28,28,5308,5332,52,10692,0.0036805791232213
"780","Woodbury",45,45,22274,21191,142,43607,0.0150111311098308
"781","Worth",10,10,1790,2277,27,4094,0.00140930517494089
"782","Wright",13,13,3625,2922,18,6565,0.0022599141361717
"783","Ada",146,146,93870,58230,0,152100,0.0523584067192256
"784","Adams",6,6,1468,555,0,2023,0.00069639090593684
"785","Bannock",54,54,21479,12903,0,34382,0.0118355472703512
"786","Bear Lake",14,14,2506,494,0,3000,0.0010327101917007
"787","Benewah",11,11,2823,1148,0,3971,0.00136696405708116
"788","Bingham",22,22,12734,3605,0,16339,0.00562448394073259
"789","Blaine",15,15,4034,5992,0,10026,0.00345131746066375
"790","Boise",7,7,2501,970,0,3471,0.00119484569179771
"791","Bonner",33,33,10697,6649,0,17346,0.00597113032841346
"792","Bonneville",52,52,30047,8352,0,38399,0.0132183462170384
"793","Boundary",7,7,3012,1268,0,4280,0.00147333320682633
"794","Butte",4,4,1078,321,0,1399,0.000481587186063094
"795","Camas",2,2,450,139,0,589,0.000202755434303904
"796","Canyon",53,53,41599,13415,0,55014,0.0189378394954075
"797","Caribou",10,10,2753,491,0,3244,0.00111670395395903
"798","Cassia",26,26,6562,1153,0,7715,0.00265578637632364
"799","Clark",3,3,302,46,0,348,0.000119794382237281
"800","Clearwater",15,15,2839,1117,0,3956,0.00136180050612266
"801","Custer",10,10,1762,559,0,2321,0.000798973451645776
"802","Elmore",18,18,5940,1931,0,7871,0.00270948730629208
"803","Franklin",17,17,4527,456,0,4983,0.00171533162841487
"804","Fremont",15,15,4965,751,0,5716,0.0019676571519204
"805","Gem",14,14,5415,1628,0,7043,0.00242445929338268
"806","Gooding",8,8,3973,1278,0,5251,0.0018075870722068
"807","Idaho County",27,27,6017,1686,0,7703,0.00265165553555684
"808","Jefferson",18,18,7703,1084,0,8787,0.00302480815149136
"809","Jerome",11,11,5177,1344,0,6521,0.00224476772002676
"810","Kootenai",75,75,36173,17584,0,53757,0.0185051339250849
"811","Latah",33,33,8686,8430,0,17116,0.00589195588038307
"812","Lemhi",14,14,3079,915,0,3994,0.0013748815018842
"813","Lewis",8,8,1359,440,0,1799,0.000619281878289854
"814","Lincoln",6,6,1388,466,0,1854,0.000638214898471034
"815","Madison",20,20,10693,826,0,11519,0.00396526289940013
"816","Minidoka",12,12,5797,1331,0,7128,0.00245371941548087
"817","Nez Perce",37,37,11009,6476,0,17485,0.00601897923396226
"818","Oneida",6,6,1789,304,0,2093,0.000720487477076523
"819","Owyhee",13,13,2859,685,0,3544,0.0012199749731291
"820","Payette",11,11,6256,1848,0,8104,0.00278969446451416
"821","Power",7,7,2105,829,0,2934,0.00100999056748329
"822","Shoshone",19,19,2921,2331,0,5252,0.00180793130893736
"823","Teton",3,3,2235,1614,0,3849,0.001324967175952
"824","Twin Falls",47,47,19535,6400,0,25935,0.00892777960725257
"825","Valley",9,9,2863,1843,0,4706,0.00161997805404783
"826","Washington",11,11,3274,1033,0,4307,0.00148262759855164
"827","Adams",80,80,20788,10467,0,31255,0.0107591190138685
"828","Alexander",11,11,1823,1978,0,3801,0.00130844381288479
"829","Bond",25,25,4068,3228,0,7296,0.00251155118621611
"830","Boone",38,38,11132,8286,0,19418,0.00668438883414808
"831","Brown",14,14,1678,891,0,2569,0.000884344160826368
"832","Bureau",51,51,9822,7961,0,17783,0.00612156177967119
"833","Calhoun",8,8,1317,1367,0,2684,0.000923931384841561
"834","Carroll",22,22,4534,3537,0,8071,0.00277833465240546
"835","Cass",21,21,3163,2492,0,5655,0.00194665871135582
"836","Champaign",117,117,39865,41455,0,81320,0.0279933309297004
"837","Christian",30,30,9042,6111,0,15153,0.00521621917828025
"838","Clark",23,23,5082,2877,0,7959,0.00273978013858196
"839","Clay",22,22,4416,2101,0,6517,0.00224339077310449
"840","Clinton",39,39,10205,6792,0,16997,0.00585099170944561
"841","Coles",44,44,13013,9564,0,22577,0.00777183266600892
"842","Cook",5111,5106,583774,1389631,0,1973405,0.679318485284375
"843","Crawford",24,24,6081,3192,0,9273,0.00319210720254687
"844","Cumberland",12,12,3497,1862,0,5359,0.00184476463910802
"845","DeKalb",81,81,21095,19263,0,40358,0.013892705972219
"846","DeWitt",23,23,4920,2836,0,7756,0.00266990008227688
"847","Douglas",20,20,5702,2767,0,8469,0.00291534087117108
"848","DuPage",733,732,203195,168363,0,371558,0.127903911135976
"849","Edgar",29,29,5256,3093,0,8349,0.00287403246350305
"850","Edwards",12,12,2412,930,0,3342,0.00115043915355458
"851","Effingham",37,37,11769,4382,0,16151,0.00555976743538601
"852","Fayette",32,32,5879,3570,0,9449,0.00325269286712664
"853","Ford",22,22,4511,1912,0,6423,0.0022110325204312
"854","Franklin",35,35,10385,8815,0,19200,0.00660934522688449
"855","Fulton",57,57,7818,9080,0,16898,0.00581691227311949
"856","Gallatin",13,13,1619,1577,0,3196,0.00110018059089181
"857","Greene",24,24,3557,2455,0,6012,0.00206955122416821
"858","Grundy",39,39,11191,8462,0,19653,0.0067652844658313
"859","Hamilton",18,18,2653,1814,0,4467,0.00153770547544235
"860","Hancock",35,35,5837,3975,0,9812,0.00337765080032243
"861","Hardin",7,7,1501,923,0,2424,0.000834429834894167
"862","Henderson",13,13,1857,2269,0,4126,0.00142032075031903
"863","Henry",52,52,13212,11877,0,25089,0.00863655533319297
"864","Iroquois",37,37,9909,3828,0,13737,0.00472877996779751
"865","Jackson",61,61,11182,14275,0,25457,0.00876323445004159
"866","Jasper",16,16,3529,1781,0,5310,0.00182789703931024
"867","Jefferson",37,37,10158,6712,0,16870,0.00580727364466361
"868","Jersey",25,25,5434,4596,0,10030,0.00345269440758601
"869","JoDaviess",29,29,6171,5310,0,11481,0.00395218190363859
"870","Johnson",17,17,3997,1813,0,5810,0.00200001540459369
"871","Kane",295,295,94010,75625,0,169635,0.0583945977897162
"872","Kankakee",88,88,24717,19989,0,44706,0.0153894472767239
"873","Kendall",61,61,19104,11931,0,31035,0.0106833869331438
"874","Knox",61,61,11104,13396,0,24500,0.00843379989888907
"875","Lake",458,458,139006,134231,0,273237,0.0940582115499082
"876","LaSalle",128,128,26091,24251,0,50342,0.0173295654901989
"877","Lawrence",27,27,4160,2518,0,6678,0.00229881288672576
"878","Lee",49,49,9304,6415,0,15719,0.00541105716778111
"879","Livingston",52,52,10316,5632,0,15948,0.00548988737908093
"880","Logan",45,45,9108,4271,0,13379,0.00460554321825456
"881","Macon",87,87,28077,23293,0,51370,0.0176834408492217
"882","Macoupin",61,61,11413,11193,0,22606,0.00778181553119536
"883","Madison",232,232,59262,63269,0,122531,0.0421796708330929
"884","Marion",48,48,9410,7691,0,17101,0.00588679232942457
"885","Marshall",16,16,3732,2806,0,6538,0.0022506197444464
"886","Mason",24,24,3907,3215,0,7122,0.00245165399509747
"887","Massac",17,17,4578,2804,0,7382,0.00254115554504486
"888","McDonough",31,31,7645,7109,0,14754,0.00507886872278405
"889","McHenry",200,200,76371,50294,0,126665,0.0436027454772565
"890","McLean",110,110,41265,29865,0,71130,0.0244855586452236
"891","Menard",16,16,4406,2137,0,6543,0.00225234092809923
"892","Mercer",28,28,4403,4512,0,8915,0.00306887045300392
"893","Monroe",37,37,9458,6783,0,16241,0.00559074874113703
"894","Montgomery",42,42,6851,5979,0,12830,0.00441655725317334
"895","Morgan",40,40,9392,5650,0,15042,0.00517800890118732
"896","Moultrie",18,18,4026,2388,0,6414,0.0022079343898561
"897","Ogle",52,52,14918,9018,0,23936,0.00823965038284933
"898","Peoria",146,146,40968,41062,0,82030,0.0282377390084029
"899","Perry",27,27,5588,4769,0,10357,0.00356525981848139
"900","Piatt",16,16,5392,3124,0,8516,0.00293151999750773
"901","Pike",34,34,5030,2847,0,7877,0.00271155272667548
"902","Pope",6,6,1500,918,0,2418,0.000832364414510766
"903","Pulaski",11,11,1720,1372,0,3092,0.00106437997091286
"904","Putnam",8,8,1623,1704,0,3327,0.00114527560259608
"905","Randolph",37,37,8073,6765,0,14838,0.00510778460815167
"906","Richland",22,22,5152,2528,0,7680,0.0026437380907538
"907","Rock Island",120,120,29661,39879,0,69540,0.0239382222436223
"908","Saline",43,43,7056,4697,0,11753,0.00404581429435278
"909","Sangamon",246,246,55824,38564,0,94388,0.0324918165247486
"910","Schuyler",17,17,2402,1593,0,3995,0.00137522573861477
"911","Scott",10,10,1696,927,0,2623,0.00090293294427698
"912","Shelby",33,33,6749,3744,0,10493,0.00361207601383849
"913","St Clair",225,225,50149,62355,0,112504,0.0387280091356986
"914","Stark",11,11,1841,1189,0,3030,0.00104303729361771
"915","Stephenson",46,46,12204,8909,0,21113,0.00726787009245897
"916","Tazewell",130,130,36037,25803,0,61840,0.0212875994182571
"917","Union",20,20,5325,3730,0,9055,0.00311706359528329
"918","Vermilion",98,98,18723,14721,0,33444,0.0115126532170794
"919","Wabash",16,16,4210,1751,0,5961,0.0020519951509093
"920","Warren",28,28,4474,3938,0,8412,0.00289571937752877
"921","Washington",24,24,5072,2986,0,8058,0.00277385957490809
"922","Wayne",28,28,6102,2139,0,8241,0.00283685489660183
"923","White",27,27,5180,3071,0,8251,0.0028402972639075
"924","Whiteside",60,60,12949,13713,0,26662,0.00917803971037471
"925","Will",391,391,128983,115499,0,244482,0.084159684362457
"926","Williamson",65,65,18080,11677,0,29757,0.0102434523914793
"927","Winnebago",241,241,58887,58054,0,116941,0.0402553875092239
"928","Woodford",35,35,12682,5994,0,18676,0.00642896518006744
"929","Adams",30,30,9733,3512,0,13245,0.0045594154963586
"930","Allen",232,232,81586,46385,0,127971,0.0440523186473768
"931","Bartholomew",67,67,19093,9191,0,28284,0.00973639168735422
"932","Benton",15,15,2797,1135,0,3932,0.00135353882458905
"933","Blackford",12,12,3447,1903,0,5350,0.00184166650853292
"934","Boone",47,47,17055,5636,0,22691,0.00781107565329354
"935","Brown",12,12,4511,2729,0,7240,0.00249227392930436
"936","Carroll",19,19,5863,2689,0,8552,0.00294391251980813
"937","Cass",39,39,9432,4290,0,13722,0.00472361641683901
"938","Clark",75,75,24495,17648,0,42143,0.0145071685362809
"939","Clay",23,23,7361,3333,0,10694,0.00368126759668244
"940","Clinton",39,39,8470,3334,0,11804,0.0040633703676117
"941","Crawford",17,17,2609,1932,0,4541,0.0015631789935043
"942","Daviess",28,28,7934,2573,0,10507,0.00361689532806643
"943","Dearborn",45,45,14231,6596,0,20827,0.00716941838751684
"944","Decatur",20,20,7499,2621,0,10120,0.00348367571333703
"945","DeKalb",39,39,10141,4696,0,14837,0.00510744037142111
"946","Delaware",75,75,27053,20429,0,47482,0.0163450484407776
"947","Dubois",37,37,11726,5210,0,16936,0.00582999326888103
"948","Elkhart",105,105,42933,17947,0,60880,0.0209571321569129
"949","Fayette",28,28,5761,3626,0,9387,0.0032313501898315
"950","Floyd",60,60,19877,13857,0,33734,0.0116124818689438
"951","Fountain",22,22,5260,2477,0,7737,0.00266335958439611
"952","Franklin",24,24,6978,2299,0,9277,0.00319348414946914
"953","Fulton",17,17,6027,2607,0,8634,0.00297213993171462
"954","Gibson",38,38,9133,5378,0,14511,0.0049952191972563
"955","Grant",65,65,18769,8509,0,27278,0.00939008953640392
"956","Greene",32,32,8666,4589,0,13255,0.00456285786366427
"957","Hamilton",165,165,77883,26387,0,104270,0.0358935638962107
"958","Hancock",38,38,20710,6891,0,27601,0.00950127800037702
"959","Harrison",35,35,11015,6171,0,17186,0.00591605245152275
"960","Hendricks",87,87,38430,13548,0,51978,0.0178927367814064
"961","Henry",42,42,13136,7176,0,20312,0.00699213647127489
"962","Howard",67,67,23714,12998,0,36712,0.0126376188525721
"963","Huntington",34,34,11615,3877,0,15492,0.00533291542994243
"964","Jackson",33,33,11079,5092,0,16171,0.00556665216999735
"965","Jasper",29,29,8055,3678,0,11733,0.00403892955974145
"966","Jay",21,21,5425,2740,0,8165,0.00281069290507874
"967","Jefferson",26,26,7763,5117,0,12880,0.00443376908970168
"968","Jennings",25,25,6864,3538,0,10402,0.0035807504713569
"969","Johnson",104,104,37765,13109,0,50874,0.0175126994308605
"970","Knox",36,36,9988,5647,0,15635,0.00538214128241349
"971","Kosciusko",65,65,22136,5977,0,28113,0.00967752720642728
"972","LaGrange",16,16,6430,2523,0,8953,0.00308195144876546
"973","Lake",549,540,68512,108219,0,176731,0.0608373016298189
"974","LaPorte",74,74,20916,21114,0,42030,0.0144682697857268
"975","Lawrence",39,39,12207,5346,0,17553,0.00604238733164081
"976","Madison",110,110,32526,21882,0,54408,0.0187292320366839
"977","Marion",915,915,155843,161957,0,317800,0.109398432974161
"978","Marshall",28,28,12074,5593,0,17667,0.00608163031892543
"979","Martin",18,18,3414,1522,0,4936,0.00169915250207822
"980","Miami",31,31,9548,3867,0,13415,0.00461793574055497
"981","Monroe",96,96,22832,26962,0,49794,0.0171409237618483
"982","Montgomery",27,27,10901,3536,0,14437,0.00496974567919435
"983","Morgan",48,48,19176,6640,0,25816,0.00888681543631511
"984","Newton",18,18,3756,2032,0,5788,0.00199244219652122
"985","Noble",29,29,10859,4696,0,15555,0.00535460234396814
"986","Ohio",11,11,1794,1139,0,2933,0.00100964633075272
"987","Orange",22,22,5683,2885,0,8568,0.0029494203074972
"988","Owen",19,19,5000,2536,0,7536,0.00259416800155216
"989","Parke",17,17,4550,2362,0,6912,0.00237936428167842
"990","Perry",21,21,4136,4210,0,8346,0.00287299975331135
"991","Pike",18,18,3745,2418,0,6163,0.00212153097048381
"992","Porter",124,124,34688,29313,0,64001,0.0220314949930122
"993","Posey",33,33,7829,4084,0,11913,0.00410089217124349
"994","Pulaski",15,15,3797,1750,0,5547,0.0019094811444546
"995","Putnam",29,29,8906,4099,0,13005,0.00447679868102254
"996","Randolph",25,25,7172,3812,0,10984,0.00378109624854684
"997","Ripley",27,27,8224,3510,0,11734,0.00403927379647201
"998","Rush",20,20,5362,1999,0,7361,0.00253392657370296
"999","Scott",16,16,4793,3822,0,8615,0.00296559943383385
"1000","Shelby",39,39,11397,4519,0,15916,0.00547887180370279
"1001","Spencer",24,24,5922,3917,0,9839,0.00338694519204774
"1002","St Joseph",218,218,55254,52637,0,107891,0.0371400450975935
"1003","Starke",21,21,4846,3987,0,8833,0.00304064304109743
"1004","Steuben",19,19,8431,4345,0,12776,0.00439796846972272
"1005","Sullivan",20,20,4999,3341,0,8340,0.00287093433292795
"1006","Switzerland",12,12,2161,1479,0,3640,0.00125302169926352
"1007","Tippecanoe",82,82,30729,20683,0,51412,0.0176978987919055
"1008","Tipton",16,16,5545,2202,0,7747,0.00266680195170178
"1009","Union",10,10,2266,1045,0,3311,0.00113976781490701
"1010","Vanderburgh",139,139,41463,28767,0,70230,0.0241757455877134
"1011","Vermillion",17,17,3738,3583,0,7321,0.00252015710448028
"1012","Vigo",87,87,20988,18426,0,39414,0.0135677464985638
"1013","Wabash",25,25,9402,3812,0,13214,0.00454874415771103
"1014","Warren",13,13,2565,1356,0,3921,0.00134975222055282
"1015","Warrick",59,59,16930,8980,0,25910,0.0089191736889884
"1016","Washington",22,22,6915,3879,0,10794,0.00371569126973913
"1017","Wayne",58,58,16586,10775,0,27361,0.00941866118504097
"1018","Wells",22,22,9163,3106,0,12269,0.0042234404473253
"1019","White",23,23,6974,3277,0,10251,0.0035287707250413
"1020","Whitley",34,34,9510,3878,0,13388,0.00460864134882967
"1021","Allen",21,21,3808,1885,53,5746,0.00197798425383741
"1022","Anderson",18,18,2490,1291,40,3821,0.00131532854749613
"1023","Atchison",17,17,3769,3028,62,6859,0.00236111973495837
"1024","Barber",23,23,1754,585,19,2358,0.000811710210676752
"1025","Barton",40,40,8545,2837,106,11488,0.00395459156075255
"1026","Bourbon",20,20,4268,2167,62,6497,0.00223650603849315
"1027","Brown",19,19,3034,1234,33,4301,0.00148056217816824
"1028","Butler",45,45,18069,7307,170,25546,0.00879387151906205
"1029","Chase",11,11,1043,413,12,1468,0.00050533952047221
"1030","Chautauqua",15,15,1496,400,10,1906,0.000656115208460513
"1031","Cherokee",39,39,6045,3694,69,9808,0.00337627385340016
"1032","Cheyenne",9,9,1346,317,9,1672,0.000575563813507858
"1033","Clark",7,7,998,254,8,1260,0.000433738280514295
"1034","Clay",23,23,3119,777,21,3917,0.00134837527363055
"1035","Cloud",27,27,3134,1179,42,4355,0.00149915096161885
"1036","Coffey",17,17,3204,1076,33,4313,0.00148469301893504
"1037","Comanche",5,5,765,198,3,966,0.000332532681727626
"1038","Cowley",57,57,9237,4747,118,14102,0.00485442637445443
"1039","Crawford",51,51,8423,7470,176,16069,0.00553154002347953
"1040","Decatur",28,28,1354,355,20,1729,0.000595185307150171
"1041","Dickinson",32,32,6186,2316,70,8572,0.00295079725441947
"1042","Doniphan",14,14,2460,1049,25,3534,0.00121653260582343
"1043","Douglas",68,68,19923,27282,586,47791,0.0164514175905227
"1044","Edwards",16,16,1072,383,18,1473,0.000507060704125045
"1045","Elk",11,11,1114,367,17,1498,0.000515666622389217
"1046","Ellis",31,31,7683,3938,151,11772,0.00405235479223355
"1047","Ellsworth",26,26,2246,794,22,3062,0.00105405286899585
"1048","Finney",30,30,7361,2303,62,9726,0.00334804644149368
"1049","Ford",25,25,6460,2212,61,8733,0.00300621936804074
"1050","Franklin",26,26,7278,3874,102,11254,0.0038740401657999
"1051","Geary",39,39,4553,2436,56,7045,0.00242514776684382
"1052","Gove",10,10,1182,245,12,1439,0.00049535665528577
"1053","Graham",16,16,1067,330,10,1407,0.000484341079907629
"1054","Grant",5,5,2082,549,11,2642,0.000909473442157752
"1055","Gray",7,7,1730,387,17,2134,0.000734601183029766
"1056","Greeley",4,4,577,137,9,723,0.000248883156199869
"1057","Greenwood",19,19,2247,899,30,3176,0.00109329585628048
"1058","Hamilton",12,12,874,222,5,1101,0.000379004640354158
"1059","Harper",12,12,2123,717,28,2868,0.000987270943265871
"1060","Harvey",33,33,9364,5237,170,14771,0.00508472074720369
"1061","Haskell",8,8,1309,221,10,1540,0.000530124565073027
"1062","Hodgeman",11,11,949,222,6,1177,0.000405166631877242
"1063","Jackson",19,19,3682,2026,44,5752,0.00198004967422081
"1064","Jefferson",14,14,5345,3226,78,8649,0.00297730348267312
"1065","Jewell",26,26,1494,384,13,1891,0.000650951657502009
"1066","Johnson",415,415,153718,95002,1368,250088,0.086089475474015
"1067","Kearny",10,10,1160,272,4,1436,0.000494323945094069
"1068","Kingman",28,28,2795,902,27,3724,0.00128193758463114
"1069","Kiowa",6,6,1248,253,18,1519,0.000522895593731122
"1070","Labette",37,37,5345,3582,76,9003,0.00309916328529381
"1071","Lane",12,12,815,179,4,998,0.000343548257105767
"1072","Leavenworth",44,44,15609,10802,182,26593,0.00915428737596559
"1073","Lincoln",23,23,1350,390,23,1763,0.000606889355989446
"1074","Linn",14,14,2954,1592,36,4582,0.00157729269945754
"1075","Logan",13,13,1252,248,13,1513,0.000520830173347721
"1076","Lyon",39,39,7604,5003,146,12753,0.00439005102491968
"1077","Marion",32,32,4393,1496,66,5955,0.00204992973052589
"1078","Marshall",31,31,3217,1754,39,5010,0.00172462602014017
"1079","McPherson",33,33,9395,3538,109,13042,0.00448953544005352
"1080","Meade",9,9,1721,349,12,2082,0.000716700873040287
"1081","Miami",30,30,8645,4681,85,13411,0.0046165587936327
"1082","Mitchell",25,25,2577,687,25,3289,0.00113219460683454
"1083","Montgomery",48,48,9435,4254,97,13786,0.00474564756759529
"1084","Morris",16,16,1945,921,28,2894,0.000996221098260611
"1085","Morton",11,11,1258,275,5,1538,0.000529436091611893
"1086","Nemaha",30,30,3966,1336,39,5341,0.00183856837795782
"1087","Neosho",25,25,4530,2318,66,6914,0.00238005275513955
"1088","Ness",11,11,1387,379,16,1782,0.000613429853870217
"1089","Norton",12,12,2069,472,21,2562,0.000881934503712399
"1090","Osage",24,24,4698,2482,74,7254,0.0024970932435323
"1091","Osborne",30,30,1552,444,25,2021,0.000695702432475706
"1092","Ottawa",24,24,2330,595,26,2951,0.00101584259190292
"1093","Pawnee",25,25,2144,759,26,2929,0.00100826938383045
"1094","Phillips",28,28,2206,550,20,2776,0.000955601164053716
"1095","Pottawatomie",28,28,6210,2147,89,8446,0.00290742342636804
"1096","Pratt",13,13,3075,1181,37,4293,0.0014778082843237
"1097","Rawlins",18,18,1408,288,7,1703,0.000586235152155432
"1098","Reno",79,79,17139,8739,263,26141,0.00899869237374935
"1099","Republic",24,24,2205,601,20,2826,0.000972813000582061
"1100","Rice",26,26,3124,1116,39,4279,0.00147298897009577
"1101","Riley",41,41,12415,7774,218,20407,0.00702483896067874
"1102","Rooks",15,15,2116,529,37,2682,0.000923242911380428
"1103","Rush",14,14,1224,516,27,1767,0.000608266302911714
"1104","Russell",17,17,2628,795,24,3447,0.00118658401026411
"1105","Saline",53,53,14758,7365,245,22368,0.00769988718932043
"1106","Scott",11,11,1897,339,17,2253,0.000775565353967227
"1107","Sedgwick",213,213,105413,61418,1276,168107,0.05786860406541
"1108","Seward",23,23,4144,1086,23,5253,0.00180827554566793
"1109","Shawnee",190,190,43467,35438,663,79568,0.0273902281777472
"1110","Sheridan",15,15,1133,232,16,1381,0.00047539092491289
"1111","Sherman",19,19,2063,630,24,2717,0.000935291196950269
"1112","Smith",26,26,1786,538,27,2351,0.000809300553562783
"1113","Stafford",24,24,1636,506,20,2162,0.000744239811485639
"1114","Stanton",4,4,780,160,4,944,0.000324959473655154
"1115","Stevens",12,12,1912,308,12,2232,0.000768336382625322
"1116","Sumner",41,41,6997,3163,90,10250,0.00352842648831073
"1117","Thomas",19,19,2959,804,27,3790,0.00130465720884855
"1118","Trego",12,12,1219,434,21,1674,0.000576252286968992
"1119","Wabaunsee",14,14,2464,982,35,3481,0.00119828805910338
"1120","Wallace",6,6,741,112,13,866,0.000298109008670936
"1121","Washington",27,27,2436,632,31,3099,0.00106678962802683
"1122","Wichita",4,4,861,183,6,1050,0.000361448567095246
"1123","Wilson",24,24,3204,1037,39,4280,0.00147333320682633
"1124","Woodson",9,9,1201,527,19,1747,0.000601381568300376
"1125","Wyandotte",159,159,17312,32781,322,50415,0.0173546947715303
"1126","Adair",16,16,5628,1764,35,7427,0.00255664619792037
"1127","Allen",13,13,5202,1923,28,7153,0.00246232533374504
"1128","Anderson",14,14,6363,3141,62,9566,0.00329296856460297
"1129","Ballard",13,13,2389,1759,15,4163,0.00143305750935001
"1130","Barren",24,24,10822,5216,63,16101,0.00554255559885767
"1131","Bath",12,12,2269,2608,29,4906,0.00168882540016121
"1132","Bell",34,34,6722,4210,48,10980,0.00377971930162457
"1133","Boone",54,54,32329,12391,189,44909,0.0154593273330289
"1134","Bourbon",18,18,4953,3198,46,8197,0.00282170848045688
"1135","Boyd",47,47,11501,10132,99,21732,0.00748095262867988
"1136","Boyle",25,25,7764,4646,52,12462,0.00428987813632472
"1137","Bracken",8,8,2363,1213,19,3595,0.00123753104638801
"1138","Breathitt",21,21,2542,3328,36,5906,0.00203306213072812
"1139","Breckinridge",15,15,5580,2884,38,8502,0.00292670068327979
"1140","Bullitt",42,42,19433,9043,106,28582,0.00983897423306315
"1141","Butler",12,12,4109,1436,20,5565,0.0019156774056048
"1142","Caldwell",13,13,4066,2245,23,6334,0.00218039545141075
"1143","Calloway",28,28,9289,5726,96,15111,0.00520176123559644
"1144","Campbell",65,65,25539,14252,212,40003,0.0137705019328677
"1145","Carlisle",7,7,1734,1102,7,2843,0.000978665025001699
"1146","Carroll",11,11,2175,1688,25,3888,0.00133839240844411
"1147","Carter",23,23,5422,5577,72,11071,0.00381104484410616
"1148","Casey",15,15,5109,1174,22,6305,0.00217041258622431
"1149","Christian",46,46,13938,6980,74,20992,0.00722621744806038
"1150","Clark",25,25,9540,5661,69,15270,0.00525649487575657
"1151","Clay",20,20,5726,1901,31,7658,0.00263616488268133
"1152","Clinton",13,13,3369,952,19,4340,0.00149398741066035
"1153","Crittenden",12,12,2726,1438,21,4185,0.00144063071742248
"1154","Cumberland",9,9,2356,848,18,3222,0.00110913074588655
"1155","Daviess",85,85,25372,15788,211,41371,0.0142414177802832
"1156","Edmonson",10,10,3595,1856,17,5468,0.00188228644273981
"1157","Elliott",7,7,871,2064,15,2950,0.00101549835517236
"1158","Estill",15,15,3633,1907,24,5564,0.00191533316887424
"1159","Fayette",251,251,66399,57989,750,125138,0.0430770959896808
"1160","Fleming",18,18,3749,2406,29,6184,0.00212875994182571
"1161","Floyd",42,42,6612,11132,88,17832,0.00613842937946897
"1162","Franklin",44,44,12281,11620,160,24061,0.0082826799741702
"1163","Fulton",13,13,1527,1340,15,2882,0.000992090257493808
"1164","Gallatin",8,8,1869,1188,7,3064,0.00105474134245698
"1165","Garrard",13,13,4784,1841,18,6643,0.00228676460115592
"1166","Grant",21,21,5951,2818,44,8813,0.0030337583064861
"1167","Graves",30,30,9903,6206,82,16191,0.00557353690460869
"1168","Grayson",23,23,7170,2905,39,10114,0.00348161029295363
"1169","Green",10,10,3866,1312,14,5192,0.00178727710510335
"1170","Greenup",32,32,8696,7630,62,16388,0.00564135154053037
"1171","Hancock",10,10,2286,1709,19,4014,0.00138176623649554
"1172","Hardin",55,55,24627,11507,207,36341,0.0125099070255317
"1173","Harlan",35,35,6659,4400,60,11119,0.00382756820717337
"1174","Harrison",17,17,4855,2807,48,7710,0.0026540651926708
"1175","Hart",19,19,4269,2470,31,6770,0.00233048266593792
"1176","Henderson",38,38,10467,8101,87,18655,0.00642173620872553
"1177","Henry",19,19,4094,2366,24,6484,0.00223203096099578
"1178","Hickman",6,6,1395,926,15,2336,0.00080413700260428
"1179","Hopkins",40,40,12314,6420,75,18809,0.00647474866523283
"1180","Jackson",14,14,4369,769,21,5159,0.00177591729299464
"1181","Jefferson",506,506,164547,170114,1784,336445,0.115816726815581
"1182","Jessamine",33,33,12972,5476,77,18525,0.00637698543375183
"1183","Johnson",31,31,5940,3288,45,9273,0.00319210720254687
"1184","Kenton",107,107,43664,22834,391,66889,0.0230256506708894
"1185","Knott",30,30,2648,4685,23,7356,0.00253220539005012
"1186","Knox",30,30,8108,3822,68,11998,0.00413015229334167
"1187","LaRue",12,12,4111,1823,27,5961,0.0020519951509093
"1188","Laurel",43,43,16819,5297,85,22201,0.00764239965531576
"1189","Lawrence",18,18,3755,2705,41,6501,0.00223788298541542
"1190","Lee",10,10,2018,878,14,2910,0.00100172888594968
"1191","Leslie",17,17,3661,1266,23,4950,0.00170397181630616
"1192","Letcher",32,32,4801,4192,41,9034,0.00310983462394138
"1193","Lewis",14,14,3778,1667,26,5471,0.00188331915293151
"1194","Lincoln",17,17,5996,2796,35,8827,0.00303857762071403
"1195","Livingston",10,10,2675,2007,14,4696,0.00161653568674217
"1196","Logan",20,20,6815,3768,32,10615,0.00365407289496765
"1197","Lyon",6,6,2132,1769,19,3920,0.00134940798382225
"1198","Madison",56,56,18922,11525,178,30625,0.0105422498736113
"1199","Magoffin",14,14,2836,2843,19,5698,0.0019614608907702
"1200","Marion",17,17,3905,3399,35,7339,0.00252635336563048
"1201","Marshall",25,25,9049,6383,54,15486,0.00533085000955902
"1202","Martin",14,14,2996,1504,24,4524,0.00155732696908466
"1203","Mason",20,20,4381,2644,36,7061,0.00243065555453289
"1204","McCracken",54,54,18218,11361,119,29698,0.0102231424243758
"1205","McCreary",18,18,4121,1530,28,5679,0.00195492039288943
"1206","McLean",8,8,2584,1823,22,4429,0.0015246244796808
"1207","Meade",18,18,7152,3724,49,10925,0.00376078628144339
"1208","Menifee",6,6,1215,1284,12,2511,0.000864378430453488
"1209","Mercer",17,17,6745,3224,47,10016,0.00344787509335808
"1210","Metcalfe",12,12,2645,1472,30,4147,0.00142754972166094
"1211","Monroe",12,12,4657,1158,16,5831,0.0020072443759356
"1212","Montgomery",17,17,5647,4506,62,10215,0.00351637820274089
"1213","Morgan",12,12,2682,2532,34,5248,0.00180655436201509
"1214","Muhlenberg",27,27,6749,6636,62,13447,0.00462895131593311
"1215","Nelson",27,27,10161,6524,111,16796,0.00578180012660166
"1216","Nicholas",5,5,1700,1332,15,3047,0.00104888931803735
"1217","Ohio",25,25,6311,3627,69,10007,0.00344477696278297
"1218","Oldham",34,34,18801,8080,151,27032,0.00930540730068446
"1219","Owen",13,13,3084,1615,28,4727,0.00162720702538974
"1220","Owsley",8,8,1558,430,8,1996,0.000687096514211534
"1221","Pendleton",12,12,4045,1940,24,6009,0.00206851851397651
"1222","Perry",37,37,6187,5400,50,11637,0.00400588283360702
"1223","Pike",57,57,12611,14002,106,26719,0.00919766120401702
"1224","Powell",11,11,2687,2249,15,4951,0.00170431605303673
"1225","Pulaski",57,57,19535,5829,107,25471,0.00876805376426953
"1226","Robertson",5,5,669,412,5,1086,0.000373841089395654
"1227","Rockcastle",14,14,4804,1320,29,6153,0.00211808860317814
"1228","Rowan",18,18,4063,4556,56,8675,0.00298625363766786
"1229","Russell",16,16,6007,1772,25,7804,0.00268642344534409
"1230","Scott",35,35,10595,6323,86,17004,0.00585340136655958
"1231","Shelby",31,31,10909,5277,83,16269,0.00560038736959291
"1232","Simpson",13,13,4273,2730,26,7029,0.00241963997915474
"1233","Spencer",9,9,4816,1970,26,6812,0.00234494060862173
"1234","Taylor",20,20,7247,2979,45,10271,0.00353565545965264
"1235","Todd",13,13,3242,1491,14,4747,0.00163409176000108
"1236","Trigg",14,14,4023,2046,28,6097,0.00209881134626639
"1237","Trimble",12,12,2332,1428,19,3779,0.00130087060481232
"1238","Union",16,16,3534,2398,31,5963,0.00205268362437043
"1239","Warren",60,60,25100,14326,177,39603,0.013632807240641
"1240","Washington",14,14,3479,1724,24,5227,0.00179932539067319
"1241","Wayne",19,19,5027,2616,31,7674,0.0026416726703704
"1242","Webster",14,14,3207,2308,29,5544,0.0019084484342629
"1243","Whitley",36,36,9559,3985,55,13599,0.00468127529897928
"1244","Wolfe",8,8,1385,1744,18,3147,0.00108331299109404
"1245","Woodford",16,16,6937,4480,60,11477,0.00395080495671632
"1246","Acadia",63,63,16083,8937,102,25122,0.00864791514530168
"1247","Allen",34,34,5140,3791,43,8974,0.00308918042010737
"1248","Ascension",60,60,24652,13952,168,38772,0.0133467465175399
"1249","Assumption",24,24,4966,5585,48,10599,0.00364856510727858
"1250","Avoyelles",50,50,8302,6976,48,15326,0.00527577213266832
"1251","Beauregard",48,48,9468,3666,36,13170,0.00453359774156608
"1252","Bienville",26,26,3539,3285,20,6844,0.00235595618399987
"1253","Bossier",68,68,29921,12116,108,42145,0.014507857009742
"1254","Caddo",154,154,54162,51502,218,105882,0.0364484735058846
"1255","Calcasieu",118,118,46058,32844,367,79269,0.0272873013953076
"1256","Caldwell",29,29,3308,1384,10,4702,0.00161860110712557
"1257","Cameron",13,13,3190,1367,23,4580,0.00157660422599641
"1258","Catahoula",31,31,3215,1673,12,4900,0.00168675997977781
"1259","Claiborne",31,31,3704,2854,10,6568,0.0022609468463634
"1260","Concordia",28,28,5426,3446,19,8891,0.00306060877147031
"1261","DeSoto",54,54,6211,5026,17,11254,0.0038740401657999
"1262","East Baton Rouge",300,300,99890,82171,630,182691,0.0628889525439977
"1263","East Carroll",24,24,1357,1980,8,3345,0.00115147186374628
"1264","East Feliciana",24,24,5020,4091,26,9137,0.00314529100718977
"1265","Evangeline",73,73,7949,5757,50,13756,0.00473532046567829
"1266","Franklin",32,32,6140,2828,20,8988,0.0030939997343353
"1267","Grant",23,23,5908,1976,34,7918,0.00272566643262872
"1268","Iberia",59,59,19416,12423,114,31953,0.0109993962518042
"1269","Iberville",45,45,6560,8063,27,14650,0.00504306810280509
"1270","Jackson",36,36,5037,2523,13,7573,0.00260690476058314
"1271","Jeff Davis",45,45,8054,4744,51,12849,0.00442309775105411
"1272","Jefferson",267,267,117692,71936,945,190573,0.065602226454326
"1273","Lafayette",121,121,57730,31205,358,89293,0.0307379303825103
"1274","Lafourche",72,72,22734,14417,191,37342,0.0128544879928292
"1275","LaSalle",29,29,5012,1154,14,6180,0.00212738299490345
"1276","Lincoln",42,42,10791,7242,41,18074,0.00622173466826616
"1277","Livingston",56,56,33948,9888,116,43952,0.0151298927818764
"1278","Madison",38,38,2291,2334,8,4633,0.00159484877271645
"1279","Morehouse",71,71,7470,5331,32,12833,0.00441758996336504
"1280","Natchitoches",51,51,9260,7396,72,16728,0.00575839202892311
"1281","Orleans",442,442,42760,151686,823,195269,0.0672187621410681
"1282","Ouachita",79,79,41747,22011,148,63906,0.0219987925036084
"1283","Plaquemines",20,20,7865,4181,46,12092,0.00416251054601496
"1284","Pointe Coupee",31,31,5429,5712,26,11167,0.00384409157024058
"1285","Rapides",105,105,34432,18904,177,53513,0.0184211401628266
"1286","Red River",20,20,2507,2140,14,4661,0.00160448740117232
"1287","Richland",40,40,5471,3082,18,8571,0.00295045301768891
"1288","Sabine",44,44,6704,2741,38,9483,0.00326439691596592
"1289","St Bernard",36,36,19596,9956,167,29719,0.0102303713957177
"1290","St Charles",45,45,14747,8895,69,23711,0.00816219711847178
"1291","St Helena",15,15,2235,3173,20,5428,0.00186851697351714
"1292","St James",28,28,4545,6406,29,10980,0.00377971930162457
"1293","St John the Baptist",35,35,8937,10293,74,19304,0.00664514584686345
"1294","St Landry",95,95,18314,18162,96,36572,0.0125894257102927
"1295","St Martin",60,60,12091,10319,77,22487,0.0077408513602579
"1296","St Mary",56,56,12876,9544,68,22488,0.00774119559698846
"1297","St Tammany",149,149,75081,24643,436,100160,0.0344787509335808
"1298","Tangipahoa",89,89,26170,15335,194,41699,0.0143543274279092
"1299","Tensas",22,22,1453,1468,1,2922,0.00100585972671648
"1300","Terrebonne",103,103,26357,13678,159,40194,0.013836251148406
"1301","Union",46,46,7457,3088,14,10559,0.0036347956380559
"1302","Vermilion",62,62,15069,9085,99,24253,0.00834877342643904
"1303","Vernon",76,76,11030,4035,49,15114,0.00520279394578814
"1304","Washington",41,41,11006,6554,58,17618,0.00606476271912766
"1305","Webster",49,49,11066,6821,48,17935,0.00617388576271736
"1306","West Baton Rouge",21,21,5820,4931,36,10787,0.00371328161262516
"1307","West Carroll",17,17,3730,1231,7,4968,0.00171016807745636
"1308","West Feliciana",18,18,2832,2214,14,5060,0.00174183785666852
"1309","Winn",41,41,4365,2056,10,6431,0.00221378641427574
"1310","Abington",4,4,3442,4179,0,7621,0.00262342812365035
"1311","Acton",6,6,3478,7047,0,10525,0.00362309158921663
"1312","Acushnet",3,3,1696,3789,0,5485,0.00188813846715945
"1313","Adams",5,5,972,3042,0,4014,0.00138176623649554
"1314","Agawam",8,8,5971,7683,0,13654,0.00470020831916046
"1315","Alford",1,1,88,205,0,293,0.000100861362056102
"1316","Amesbury",6,6,3225,4588,0,7813,0.00268952157591919
"1317","Amherst",10,10,1463,9705,0,11168,0.00384443580697115
"1318","Andover",9,9,7883,9177,0,17060,0.00587267862347133
"1319","Aquinnah",1,1,22,270,0,292,0.000100517125325535
"1320","Arlington",21,21,6422,17821,0,24243,0.00834533105913337
"1321","Ashburnham",1,1,1424,1651,0,3075,0.00105852794649322
"1322","Ashby",1,1,889,829,0,1718,0.000591398703113935
"1323","Ashfield",1,1,236,836,0,1072,0.000369021775167718
"1324","Ashland",4,4,3036,4712,0,7748,0.00266714618843235
"1325","Athol",3,3,2092,2463,0,4555,0.00156799830773223
"1326","Attleboro",12,12,7702,9838,0,17540,0.00603791225414344
"1327","Auburn",5,5,3729,4979,0,8708,0.00299761344977657
"1328","Avon",1,1,1039,1351,0,2390,0.000822725786054893
"1329","Ayer",2,2,1315,1613,0,2928,0.00100792514709989
"1330","Barnstable",13,13,11913,13183,0,25096,0.00863896499030694
"1331","Barre",2,2,1173,1321,0,2494,0.00085852640603385
"1332","Becket",1,1,280,538,0,818,0.000281585645603725
"1333","Bedford",4,4,2593,4158,0,6751,0.00232394216805715
"1334","Belchertown",4,4,2458,4300,0,6758,0.00232635182517111
"1335","Bellingham",5,5,3388,4354,0,7742,0.00266508076804894
"1336","Belmont",8,8,4274,8923,0,13197,0.00454289213329139
"1337","Berkley",1,1,1357,1541,0,2898,0.000997598045182878
"1338","Berlin",1,1,696,843,0,1539,0.00052978032834246
"1339","Bernardston",1,1,447,762,0,1209,0.000416182207255383
"1340","Beverly",12,12,7785,11513,0,19298,0.00664308042648005
"1341","Billerica",11,11,8422,9399,0,17821,0.00613464277543274
"1342","Blackstone",3,3,1816,2206,0,4022,0.00138452013034007
"1343","Blandford",1,1,322,309,0,631,0.000217213376987714
"1344","Bolton",1,1,1177,1421,0,2598,0.000894327026012808
"1345","Boston",254,254,44103,158922,0,203025,0.069888662223345
"1346","Bourne",6,6,4034,4190,0,8224,0.00283100287218219
"1347","Boxborough",1,1,989,1528,0,2517,0.000866443850836889
"1348","Boxford",3,3,2664,2059,0,4723,0.00162583007846747
"1349","Boylston",1,1,1113,1302,0,2415,0.000831331704319065
"1350","Braintree",12,12,7792,10207,0,17999,0.00619591691347364
"1351","Brewster",3,3,2725,3822,0,6547,0.0022537178750215
"1352","Bridgewater",7,7,5499,5561,0,11060,0.00380725824006992
"1353","Brimfield",1,1,893,917,0,1810,0.00062306848232609
"1354","Brockton",28,28,10041,20019,0,30060,0.010347756120841
"1355","Brookfield",1,1,782,816,0,1598,0.000550090295445907
"1356","Brookline",16,16,5202,21065,0,26267,0.00904206620180078
"1357","Buckland",1,1,312,684,0,996,0.000342859783644633
"1358","Burlington",6,6,5238,6745,0,11983,0.00412498874238317
"1359","Cambridge",33,33,5275,35241,0,40516,0.0139470953756485
"1360","Canton",6,6,4864,6461,0,11325,0.00389848097367015
"1361","Carlisle",1,1,1124,1946,0,3070,0.00105680676284039
"1362","Carver",3,3,2728,3050,0,5778,0.00198899982921555
"1363","Charlemont",1,1,223,431,0,654,0.000225130821790753
"1364","Charlton",3,3,2983,1639,0,4622,0.00159106216868021
"1365","Chatham",2,2,2340,2421,0,4761,0.00163891107422901
"1366","Chelmsford",9,9,8478,9670,0,18148,0.00624720818632811
"1367","Chelsea",16,16,1823,5116,0,6939,0.00238865867340372
"1368","Cheshire",1,1,542,1251,0,1793,0.000617216457906453
"1369","Chester",1,1,330,322,0,652,0.000224442348329619
"1370","Chesterfield",1,1,293,362,0,655,0.00022547505852132
"1371","Chicopee",26,26,7956,14640,0,22596,0.00777837316388969
"1372","Chilmark",1,1,156,577,0,733,0.000252325523505538
"1373","Clarksburg",1,1,267,592,0,859,0.000295699351556968
"1374","Clinton",4,4,2397,3514,0,5911,0.00203478331438095
"1375","Cohasset",2,2,2164,2284,0,4448,0.00153116497756157
"1376","Colrain",1,1,314,545,0,859,0.000295699351556968
"1377","Concord",5,5,3179,6774,0,9953,0.00342618817933236
"1378","Conway",1,1,309,844,0,1153,0.000396904950343636
"1379","Cummington",1,1,173,370,0,543,0.000186920544697827
"1380","Dalton",2,2,1039,2446,0,3485,0.00119966500602565
"1381","Danvers",8,8,6086,7046,0,13132,0.00452051674580454
"1382","Dartmouth",10,10,4848,10204,0,15052,0.00518145126849299
"1383","Dedham",7,7,4859,7392,0,12251,0.0042172441861751
"1384","Deerfield",1,1,861,2114,0,2975,0.00102410427343653
"1385","Dennis",5,5,4320,5236,0,9556,0.0032895261972973
"1386","Dighton",1,1,1475,1743,0,3218,0.00110775379896429
"1387","Douglas",2,2,2048,1866,0,3914,0.00134734256343885
"1388","Dover",1,1,1685,1602,0,3287,0.0011315061333734
"1389","Dracut",10,10,6671,6972,0,13643,0.00469642171512423
"1390","Dudley",4,4,2173,2617,0,4790,0.00164889393941545
"1391","Dunstable",1,1,883,842,0,1725,0.000593808360227904
"1392","Duxbury",6,6,4581,4454,0,9035,0.00311017886067195
"1393","East Bridgewater",4,4,3393,3116,0,6509,0.00224063687925996
"1394","East Brookfield",1,1,623,467,0,1090,0.000375218036317922
"1395","East Longmeadow",4,4,3993,4204,0,8197,0.00282170848045688
"1396","Eastham",1,1,1479,2227,0,3706,0.00127574132348093
"1397","Easthampton",5,5,2651,5496,0,8147,0.00280449664392854
"1398","Easton",6,6,5418,5856,0,11274,0.00388092490041124
"1399","Edgartown",1,1,793,1532,0,2325,0.000800350398568044
"1400","Egremont",1,1,199,591,0,790,0.000271947017147852
"1401","Erving",1,1,263,499,0,762,0.000262308388691978
"1402","Essex",1,1,954,1123,0,2077,0.000714979689387453
"1403","Everett",18,18,4025,8719,0,12744,0.00438695289434458
"1404","Fairhaven",6,6,2413,5663,0,8076,0.00278005583605829
"1405","Fall River",30,30,7225,23396,0,30621,0.0105408729266891
"1406","Falmouth",9,9,7775,11212,0,18987,0.00653602280327374
"1407","Fitchburg",12,12,5007,8416,0,13423,0.00462068963439951
"1408","Florida",1,1,131,267,0,398,0.000137006218765626
"1409","Foxborough",5,5,4010,4618,0,8628,0.00297007451133122
"1410","Framingham",18,18,8433,17195,0,25628,0.00882209893096853
"1411","Franklin",8,8,6851,8135,0,14986,0.00515873164427557
"1412","Freetown",3,3,1909,2428,0,4337,0.00149295470046865
"1413","Gardner",11,11,2950,5014,0,7964,0.0027415013222348
"1414","Georgetown",2,2,2088,2095,0,4183,0.00143994224396135
"1415","Gill",1,1,262,618,0,880,0.000302928322898873
"1416","Gloucester",10,10,5054,9280,0,14334,0.00493428929594595
"1417","Goshen",1,1,202,361,0,563,0.000193805279309165
"1418","Gosnold",1,1,34,41,0,75,2.58177547925176e-05
"1419","Grafton",4,4,3651,4293,0,7944,0.00273461658762346
"1420","Granby",1,1,1405,1894,0,3299,0.00113563697414021
"1421","Granville",1,1,449,374,0,823,0.000283306829256559
"1422","Great Barrington",4,4,727,2927,0,3654,0.00125784101349146
"1423","Greenfield",9,9,2366,5955,0,8321,0.00286439383504718
"1424","Groton",3,3,2540,3162,0,5702,0.00196283783769247
"1425","Groveland",1,1,1754,1780,0,3534,0.00121653260582343
"1426","Hadley",1,1,953,2049,0,3002,0.00103339866516184
"1427","Halifax",2,2,1893,1894,0,3787,0.00130362449865685
"1428","Hamilton",3,3,2374,2117,0,4491,0.00154596715697595
"1429","Hampden",1,1,1420,1376,0,2796,0.000962485898665054
"1430","Hancock",1,1,143,251,0,394,0.000135629271843359
"1431","Hanover",4,4,3967,3563,0,7530,0.00259210258116876
"1432","Hanson",3,3,2534,2570,0,5104,0.00175698427281346
"1433","Hardwick",1,1,548,778,0,1326,0.00045645790473171
"1434","Harvard",1,1,1199,2082,0,3281,0.00112944071299
"1435","Harwich",4,4,3687,4329,0,8016,0.00275940163222428
"1436","Hatfield",1,1,689,1369,0,2058,0.000708439191506682
"1437","Haverhill",21,21,10253,13879,0,24132,0.00830712078204045
"1438","Hawley",1,1,68,121,0,189,6.50607420771442e-05
"1439","Heath",1,1,156,267,0,423,0.000145612137029799
"1440","Hingham",6,6,5605,6213,0,11818,0.00406818968183963
"1441","Hinsdale",1,1,310,741,0,1051,0.000361792803825813
"1442","Holbrook",4,4,2283,3043,0,5326,0.00183340482699931
"1443","Holden",5,5,4683,4986,0,9669,0.00332842494785136
"1444","Holland",1,1,578,570,0,1148,0.000395183766690802
"1445","Holliston",4,4,3070,4565,0,7635,0.00262824743787829
"1446","Holyoke",14,14,4505,10006,0,14511,0.0049952191972563
"1447","Hopedale",1,1,1372,1822,0,3194,0.00109949211743068
"1448","Hopkinton",4,4,3594,3896,0,7490,0.00257833311194609
"1449","Hubbardston",1,1,1106,1065,0,2171,0.000747337942060741
"1450","Hudson",7,7,3481,5265,0,8746,0.00301069444553811
"1451","Hull",3,3,2030,3742,0,5772,0.00198693440883215
"1452","Huntington",1,1,492,530,0,1022,0.000351809938639372
"1453","Ipswich",4,4,3356,4281,0,7637,0.00262893591133942
"1454","Kingston",4,4,3057,3226,0,6283,0.00216283937815184
"1455","Lakeville",3,3,2912,2389,0,5301,0.00182479890873514
"1456","Lancaster",2,2,1651,1653,0,3304,0.00113735815779304
"1457","Lanesborough",1,1,482,1128,0,1610,0.00055422113621271
"1458","Lawrence",24,24,4783,11482,0,16265,0.00559901042267064
"1459","Lee",6,6,855,2155,0,3010,0.00103615255900637
"1460","Leicester",4,4,2315,2772,0,5087,0.00175113224839382
"1461","Lenox",1,1,801,2247,0,3048,0.00104923355476791
"1462","Leominster",15,15,7288,10001,0,17289,0.00595150883477115
"1463","Leverett",1,1,193,947,0,1140,0.000392429872846267
"1464","Lexington",9,9,4824,12298,0,17122,0.00589402130076647
"1465","Leyden",1,1,138,310,0,448,0.000154218055293971
"1466","Lincoln",3,3,919,2428,0,3347,0.00115216033720742
"1467","Littleton",3,3,2010,2769,0,4779,0.00164510733537922
"1468","Longmeadow",5,5,3623,5133,0,8756,0.00301413681284378
"1469","Lowell",33,33,10528,18144,0,28672,0.00986995553881418
"1470","Ludlow",6,6,3578,5684,0,9262,0.00318832059851063
"1471","Lunenburg",4,4,2475,2831,0,5306,0.00182652009238797
"1472","Lynn",28,28,8360,19360,0,27720,0.00954224217131449
"1473","Lynnfield",4,4,3625,3163,0,6788,0.00233667892708812
"1474","Malden",16,16,5725,13984,0,19709,0.00678456172274304
"1475","Manchester",1,1,1426,1821,0,3247,0.00111773666415073
"1476","Mansfield",6,6,4933,5775,0,10708,0.00368608691091037
"1477","Marblehead",7,7,4749,7128,0,11877,0.00408849964894308
"1478","Marion",1,1,1267,1738,0,3005,0.00103443137535354
"1479","Marlborough",14,14,6404,8817,0,15221,0.0052396272759588
"1480","Marshfield",7,7,6366,6926,0,13292,0.00457559462269524
"1481","Mashpee",5,5,3561,4076,0,7637,0.00262893591133942
"1482","Mattapoisett",2,2,1654,2200,0,3854,0.00132668835960484
"1483","Maynard",4,4,1983,3445,0,5428,0.00186851697351714
"1484","Medfield",4,4,3214,3614,0,6828,0.0023504483963108
"1485","Medford",16,16,7837,17494,0,25331,0.00871986062199016
"1486","Medway",4,4,3087,3613,0,6700,0.00230638609479823
"1487","Melrose",14,14,5589,9300,0,14889,0.00512534068141058
"1488","Mendon",1,1,1576,1422,0,2998,0.00103202171823957
"1489","Merrimac",1,1,1567,1792,0,3359,0.00115629117797422
"1490","Methuen",12,12,9034,9997,0,19031,0.00655116921941869
"1491","Middleborough",6,6,5123,4783,0,9906,0.00341000905299572
"1492","Middlefield",1,1,115,178,0,293,0.000100861362056102
"1493","Middleton",2,2,1936,1832,0,3768,0.00129708400077608
"1494","Milford",7,7,4774,7008,0,11782,0.00405579715953922
"1495","Millbury",4,4,2713,3410,0,6123,0.00210776150126113
"1496","Millis",3,3,1924,2407,0,4331,0.00149088928008525
"1497","Millville",1,1,688,718,0,1406,0.000483996843177062
"1498","Milton",11,11,5452,9179,0,14631,0.00503652760492432
"1499","Monroe",1,1,21,40,0,61,2.09984405645809e-05
"1500","Monson",3,3,1773,2237,0,4010,0.00138038928957327
"1501","Montague",6,6,1136,2905,0,4041,0.00139106062822085
"1502","Monterey",1,1,120,414,0,534,0.000183822414122725
"1503","Montgomery",1,1,249,213,0,462,0.000159037369521908
"1504","Mount Washington",1,1,25,76,0,101,3.4767909787257e-05
"1505","Nahant",1,1,819,1394,0,2213,0.000761795884744551
"1506","Nantucket",1,1,2040,3601,0,5641,0.00194183939712789
"1507","Natick",10,10,6000,10846,0,16846,0.00579901196313001
"1508","Needham",10,10,5832,10722,0,16554,0.00569849483780447
"1509","New Ashford",1,1,53,92,0,145,4.99143259322006e-05
"1510","New Bedford",42,42,7325,25546,0,32871,0.0113154055704646
"1511","New Braintree",1,1,243,263,0,506,0.000174183785666852
"1512","New Marlborough",1,1,256,533,0,789,0.000271602780417285
"1513","New Salem",1,1,221,359,0,580,0.000199657303728802
"1514","Newbury",2,2,1862,2155,0,4017,0.00138279894668724
"1515","Newburyport",7,7,3680,6488,0,10168,0.00350019907640425
"1516","Newton",31,31,9943,31846,0,41789,0.0143853087336602
"1517","Norfolk",4,4,2626,2281,0,4907,0.00168916963689178
"1518","North Adams",5,5,1440,4444,0,5884,0.00202548892265564
"1519","North Andover",8,8,6854,6715,0,13569,0.00467094819706227
"1520","North Attleborough",9,9,6473,6779,0,13252,0.00456182515347257
"1521","North Brookfield",1,1,1186,1009,0,2195,0.000755599623594347
"1522","North Reading",4,4,3881,3904,0,7785,0.00267988294746332
"1523","Northampton",14,14,2790,12176,0,14966,0.00515184690966424
"1524","Northborough",4,4,3350,4226,0,7576,0.00260793747077484
"1525","Northbridge",4,4,3455,3330,0,6785,0.00233564621689642
"1526","Northfield",1,1,581,1126,0,1707,0.000587612099077699
"1527","Norton",5,5,3763,4228,0,7991,0.0027507957139601
"1528","Norwell",3,3,3054,2847,0,5901,0.00203134094707528
"1529","Norwood",9,9,5544,8114,0,13658,0.00470158526608273
"1530","Oak Bluffs",1,1,697,1761,0,2458,0.000846133883733442
"1531","Oakham",1,1,500,493,0,993,0.000341827073452932
"1532","Orange",2,2,1533,1581,0,3114,0.00107195317898533
"1533","Orleans",2,2,2055,2406,0,4461,0.00153564005505894
"1534","Otis",1,1,320,422,0,742,0.00025542365408064
"1535","Oxford",4,4,2814,3297,0,6111,0.00210363066049433
"1536","Palmer",4,4,2428,3538,0,5966,0.00205371633456213
"1537","Paxton",1,1,1166,1271,0,2437,0.000838904912391537
"1538","Peabody",18,18,9528,15243,0,24771,0.0085270880528727
"1539","Pelham",1,1,151,689,0,840,0.000289158853676197
"1540","Pembroke",5,5,4234,4637,0,8871,0.00305372403685898
"1541","Pepperell",3,3,2930,2884,0,5814,0.00200139235151596
"1542","Peru",1,1,148,252,0,400,0.00013769469222676
"1543","Petersham",1,1,336,439,0,775,0.000266783466189348
"1544","Phillipston",1,1,427,396,0,823,0.000283306829256559
"1545","Pittsfield",14,14,4954,15144,0,20098,0.00691846981093357
"1546","Plainfield",1,1,105,256,0,361,0.000124269459734651
"1547","Plainville",2,2,1887,2008,0,3895,0.00134080206555808
"1548","Plymouth",14,14,11864,14159,0,26023,0.00895807243954246
"1549","Plympton",1,1,822,801,0,1623,0.00055869621371008
"1550","Princeton",1,1,1011,1106,0,2117,0.000728749158610129
"1551","Provincetown",1,1,284,2151,0,2435,0.000838216438930403
"1552","Quincy",30,30,13364,24153,0,37517,0.0129147294206784
"1553","Randolph",8,8,3738,9537,0,13275,0.00456974259827561
"1554","Raynham",3,3,3083,3222,0,6305,0.00217041258622431
"1555","Reading",8,8,5184,7226,0,12410,0.00427197782633524
"1556","Rehoboth",3,3,2659,2881,0,5540,0.00190707148734063
"1557","Revere",21,21,5351,10974,0,16325,0.00561966462650465
"1558","Richmond",1,1,225,750,0,975,0.000335630812302728
"1559","Rochester",1,1,1364,1381,0,2745,0.000944929825406142
"1560","Rockland",6,6,3652,4579,0,8231,0.00283341252929616
"1561","Rockport",3,3,1637,2930,0,4567,0.00157212914849904
"1562","Rowe",1,1,112,136,0,248,8.53707091805914e-05
"1563","Rowley",1,1,1645,1453,0,3098,0.00106644539129626
"1564","Royalston",2,2,272,338,0,610,0.000209984405645809
"1565","Russell",1,1,383,389,0,772,0.000265750755997647
"1566","Rutland",2,2,1851,1771,0,3622,0.00124682543811331
"1567","Salem",14,14,5529,12226,0,17755,0.00611192315121532
"1568","Salisbury",2,2,1717,2197,0,3914,0.00134734256343885
"1569","Sandisfield",1,1,133,267,0,400,0.00013769469222676
"1570","Sandwich",7,7,5977,5853,0,11830,0.00407232052260643
"1571","Saugus",10,10,5561,7721,0,13282,0.00457215225538957
"1572","Savoy",1,1,112,225,0,337,0.000116007778201046
"1573","Scituate",6,6,5070,5656,0,10726,0.00369228317206058
"1574","Seekonk",4,4,3018,3910,0,6928,0.00238487206936749
"1575","Sharon",5,5,2766,6689,0,9455,0.00325475828751005
"1576","Sheffield",1,1,573,1207,0,1780,0.000612741380409083
"1577","Shelburne",1,1,300,806,0,1106,0.000380725824006992
"1578","Sherborn",1,1,1107,1494,0,2601,0.000895359736204509
"1579","Shirley",1,1,1325,1533,0,2858,0.000983828575960202
"1580","Shrewsbury",9,9,7104,8971,0,16075,0.00553360544386293
"1581","Shutesbury",1,1,146,986,0,1132,0.000389675979001732
"1582","Somerset",5,5,3210,6764,0,9974,0.00343341715067427
"1583","Somerville",21,21,5208,24157,0,29365,0.010108511593097
"1584","South Hadley",5,5,3163,5333,0,8496,0.00292463526289639
"1585","Southampton",1,1,1462,1677,0,3139,0.0010805590972495
"1586","Southborough",3,3,2440,2915,0,5355,0.00184338769218575
"1587","Southbridge",5,5,2514,3983,0,6497,0.00223650603849315
"1588","Southwick",3,3,2313,2080,0,4393,0.00151223195738039
"1589","Spencer",4,4,2504,2763,0,5267,0.00181309485989587
"1590","Springfield",64,64,13028,33583,0,46611,0.0160452182484538
"1591","Sterling",2,2,2249,2089,0,4338,0.00149329893719922
"1592","Stockbridge",1,1,248,980,0,1228,0.000422722705136154
"1593","Stoneham",7,7,4725,6921,0,11646,0.00400898096418213
"1594","Stoughton",8,8,4865,8174,0,13039,0.00448850272986182
"1595","Stow",1,1,1465,2194,0,3659,0.00125956219714429
"1596","Sturbridge",2,2,2146,2466,0,4612,0.00158761980137455
"1597","Sudbury",5,5,3597,6081,0,9678,0.00333152307842646
"1598","Sunderland",1,1,379,1292,0,1671,0.000575219576777291
"1599","Sutton",3,3,2478,2173,0,4651,0.00160104503386666
"1600","Swampscott",6,6,2677,5188,0,7865,0.00270742188590867
"1601","Swansea",5,5,3034,5253,0,8287,0.00285268978620791
"1602","Taunton",16,16,7785,13170,0,20955,0.0072134806890294
"1603","Templeton",2,2,1426,1866,0,3292,0.00113322731702624
"1604","Tewksbury",8,8,6885,7730,0,14615,0.00503101981723525
"1605","Tisbury",1,1,563,1653,0,2216,0.000762828594936252
"1606","Tolland",1,1,128,109,0,237,8.15841051443555e-05
"1607","Topsfield",1,1,1889,1731,0,3620,0.00124613696465218
"1608","Townsend",3,3,2421,2179,0,4600,0.00158348896060774
"1609","Truro",1,1,392,1043,0,1435,0.000493979708363502
"1610","Tyngsborough",4,4,2810,2749,0,5559,0.0019136119852214
"1611","Tyringham",1,1,92,172,0,264,9.08784968696618e-05
"1612","Upton",1,1,1727,1961,0,3688,0.00126954506233073
"1613","Uxbridge",4,4,3094,3456,0,6550,0.0022547505852132
"1614","Wakefield",7,7,5633,7965,0,13598,0.00468093106224872
"1615","Wales",1,1,415,466,0,881,0.000303272559629439
"1616","Walpole",8,8,6110,6496,0,12606,0.00433944822552635
"1617","Waltham",18,18,8190,14468,0,22658,0.00779971584118483
"1618","Ware",3,3,1654,2589,0,4243,0.00146059644779536
"1619","Wareham",6,6,4094,5934,0,10028,0.00345200593412488
"1620","Warren",1,1,1004,1151,0,2155,0.000741830154371671
"1621","Warwick",1,1,123,269,0,392,0.000134940798382225
"1622","Washington",1,1,104,211,0,315,0.000108434570128574
"1623","Watertown",12,12,4186,10942,0,15128,0.00520761326001607
"1624","Wayland",4,4,2591,5146,0,7737,0.00266335958439611
"1625","Webster",5,5,2823,3573,0,6396,0.0022017381287059
"1626","Wellesley",7,7,5120,8368,0,13488,0.00464306502188636
"1627","Wellfleet",1,1,622,1437,0,2059,0.000708783428237248
"1628","Wendell",1,1,69,429,0,498,0.000171429891822317
"1629","Wenham",1,1,1153,1075,0,2228,0.000766959435703055
"1630","West Boylston",2,2,1774,1906,0,3680,0.00126679116848619
"1631","West Bridgewater",2,2,1989,1666,0,3655,0.00125818525022202
"1632","West Brookfield",1,1,889,963,0,1852,0.0006375264250099
"1633","West Newbury",1,1,1183,1364,0,2547,0.000876770952753896
"1634","West Springfield",8,8,5012,6645,0,11657,0.00401276756821836
"1635","West Stockbridge",1,1,196,691,0,887,0.000305337980012841
"1636","West Tisbury",1,1,331,1389,0,1720,0.000592087176575069
"1637","Westborough",5,5,3495,4893,0,8388,0.00288745769599516
"1638","Westfield",12,12,7376,8848,0,16224,0.0055848967167174
"1639","Westford",6,6,5400,5966,0,11366,0.00391259467962339
"1640","Westhampton",1,1,409,573,0,982,0.000338040469416696
"1641","Westminster",2,2,1934,2009,0,3943,0.00135732542862529
"1642","Weston",4,4,2567,3615,0,6182,0.00212807146836458
"1643","Westport",5,5,2867,5139,0,8006,0.00275595926491861
"1644","Westwood",4,4,3845,4366,0,8211,0.00282652779468482
"1645","Weymouth",18,18,10888,15330,0,26218,0.009025198602003
"1646","Whately",1,1,280,635,0,915,0.000314976608468714
"1647","Whitman",4,4,3194,3595,0,6789,0.00233702316381869
"1648","Wilbraham",4,4,3975,4075,0,8050,0.00277110568106355
"1649","Williamsburg",1,1,388,1139,0,1527,0.000525649487575657
"1650","Williamstown",3,3,758,2941,0,3699,0.00127333166636697
"1651","Wilmington",6,6,5304,5835,0,11139,0.00383445294178471
"1652","Winchendon",3,3,1815,2129,0,3944,0.00135766966535586
"1653","Winchester",8,8,4811,7091,0,11902,0.00409710556720725
"1654","Windsor",1,1,165,358,0,523,0.000180035810086489
"1655","Winthrop",6,6,3196,5540,0,8736,0.00300725207823244
"1656","Woburn",14,14,7738,10313,0,18051,0.00621381722346312
"1657","Worcester",50,50,17648,38264,0,55912,0.0192469640794566
"1658","Worthington",1,1,268,500,0,768,0.00026437380907538
"1659","Wrentham",3,3,2854,2739,0,5593,0.00192531603406068
"1660","Yarmouth",7,7,6510,7620,0,14130,0.00486406500291031
"1661","Allegany",41,41,17825,9769,156,27750,0.00955256927323149
"1662","Anne Arundel",185,185,124071,95171,1145,220387,0.0758653003394475
"1663","Baltimore",214,214,155371,170104,1909,327384,0.112697597799914
"1664","Baltimore City",316,316,33736,165055,898,199689,0.0687402884901738
"1665","Calvert",21,21,21619,14812,156,36587,0.0125945892612512
"1666","Caroline",8,8,6947,3538,63,10548,0.00363100903401967
"1667","Carroll",44,44,51840,21143,395,73378,0.025259402815538
"1668","Cecil",18,18,21428,13777,166,35371,0.0121759973968818
"1669","Charles",33,33,26357,27445,194,53996,0.0185874065036904
"1670","Dorchester",36,36,7260,4971,50,12281,0.00422757128809211
"1671","Frederick",61,61,56243,36470,454,93167,0.0320715034767264
"1672","Garrett",19,19,8431,2952,41,11424,0.00393256040999627
"1673","Harford",65,65,67397,36868,549,104814,0.0360808286776391
"1674","Howard",98,98,54768,65704,712,121184,0.0417159839570193
"1675","Kent",10,10,4437,3883,45,8365,0.00287954025119212
"1676","Montgomery",235,235,123472,244211,1994,369677,0.12725640184578
"1677","Prince Georges",209,209,50594,236698,953,288245,0.0992245164022563
"1678","Queen Annes",11,11,14380,7019,106,21505,0.0074028108908412
"1679","Somerset",22,22,4604,3737,27,8368,0.00288057296138382
"1680","St Marys",28,28,22015,12625,153,34793,0.0119770285666142
"1681","Talbot",16,16,10249,6531,85,16865,0.00580555246101078
"1682","Washington",46,46,34726,18859,252,53837,0.0185326728635302
"1683","Wicomico",33,33,20262,13873,164,34299,0.0118069756217141
"1684","Worcester",18,18,13860,8598,105,22563,0.00776701335178098
"1685","Abbot",1,1,239,169,6,414,0.000142514006454697
"1686","Acton",1,1,624,547,3,1174,0.000404133921685541
"1687","Addison",1,1,368,277,12,657,0.000226163531982454
"1688","Albany Twp",1,1,102,155,4,261,8.98457866779611e-05
"1689","Albion",1,1,607,442,18,1067,0.000367300591514883
"1690","Alexander",1,1,172,124,1,297,0.000102238308978369
"1691","Alfred",1,1,873,881,19,1773,0.000610331723295115
"1692","Allagash",1,1,89,90,2,181,6.2306848232609e-05
"1693","Alna",1,1,186,276,4,466,0.000160414316444176
"1694","Alton",1,1,269,250,5,524,0.000180380046817056
"1695","Amherst",1,1,86,65,2,153,5.26682197767358e-05
"1696","Amity",1,1,54,47,1,102,3.51121465178239e-05
"1697","Andover",1,1,283,217,3,503,0.000173151075475151
"1698","Anson",1,1,573,608,23,1204,0.000414461023602548
"1699","Appleton",1,1,368,408,9,785,0.000270225833495017
"1700","Arrowsic",1,1,104,238,9,351,0.000120827092428982
"1701","Arundel",1,1,1019,1044,24,2087,0.000718422056693122
"1702","Ashland",1,1,338,332,11,681,0.000234425213516059
"1703","Athens",1,1,203,241,5,449,0.000154562292024538
"1704","Atkinson",1,1,109,104,5,218,7.50436072635843e-05
"1705","Auburn",5,5,5216,6865,135,12216,0.00420519590060526
"1706","Augusta",5,5,4128,5492,122,9742,0.00335355422918275
"1707","Aurora",1,1,56,22,2,80,2.75389384453521e-05
"1708","Avon",1,1,143,112,2,257,8.84688397556935e-05
"1709","Baileyville",1,1,376,410,7,793,0.000272979727339552
"1710","Baldwin",1,1,453,339,2,794,0.000273323964070119
"1711","Bancroft",1,1,17,12,1,30,1.0327101917007e-05
"1712","Bangor",9,9,7119,9145,138,16402,0.0056461708547583
"1713","Bar Harbor",1,1,944,2188,53,3185,0.00109639398685558
"1714","Baring",1,1,56,64,0,120,4.13084076680281e-05
"1715","Bath",8,8,2569,3521,83,6173,0.00212497333778948
"1716","Beals",1,1,147,139,3,289,9.94844151338343e-05
"1717","Beaver Cove",1,1,67,39,1,107,3.68333301706584e-05
"1718","Beddington",1,1,22,13,0,35,1.20482855698415e-05
"1719","Belfast",3,3,1533,2270,41,3844,0.00132324599229917
"1720","Belgrade",1,1,1003,930,16,1949,0.000670917387874889
"1721","Belmont",1,1,234,240,1,475,0.000163512447019278
"1722","Benedicta Twp",1,1,53,43,3,99,3.40794363261232e-05
"1723","Benton",1,1,712,756,19,1487,0.000511880018352981
"1724","Berwick",1,1,1862,1588,31,3481,0.00119828805910338
"1725","Bethel",1,1,712,849,24,1585,0.000545615217948538
"1726","Biddeford",7,7,3754,6427,111,10292,0.00354288443099454
"1727","Bingham",1,1,297,309,4,610,0.000209984405645809
"1728","Blaine",1,1,316,138,1,455,0.00015662771240794
"1729","Blue Hill",1,1,613,1005,22,1640,0.000564548238129717
"1730","Boothbay",1,1,1010,1053,14,2077,0.000714979689387453
"1731","Boothbay Harbor",1,1,744,824,10,1578,0.000543205560834569
"1732","Bowdoin",1,1,862,628,23,1513,0.000520830173347721
"1733","Bowdoinham",1,1,734,942,31,1707,0.000587612099077699
"1734","Bowerbank",1,1,57,32,0,89,3.06370690204542e-05
"1735","Bradford",1,1,337,274,10,621,0.000213771009682045
"1736","Bradley",1,1,313,463,11,787,0.000270914306956151
"1737","Bremen",1,1,230,298,3,531,0.000182789703931024
"1738","Brewer",2,2,2850,2510,46,5406,0.00186094376544467
"1739","Bridgewater",1,1,204,135,0,339,0.000116696251662179
"1740","Bridgton",1,1,1372,1458,43,2873,0.000988992126918706
"1742","Bristol",1,1,893,1033,24,1950,0.000671261624605456
"1743","Brooklin",1,1,222,385,4,611,0.000210328642376376
"1744","Brooks",1,1,298,253,10,561,0.000193116805848031
"1745","Brooksville",1,1,257,447,8,712,0.000245096552163633
"1746","Brookton Twp",1,1,82,36,2,120,4.13084076680281e-05
"1747","Brownfield",1,1,360,458,7,825,0.000283995302717693
"1748","Brownville",1,1,404,371,19,794,0.000273323964070119
"1749","Brunswick",8,8,4212,7233,156,11601,0.00399349031130661
"1750","Buckfield",1,1,540,525,17,1082,0.000372464142473387
"1751","Bucksport",1,1,1307,1450,29,2786,0.000959043531359385
"1752","Burlington",1,1,122,90,0,212,7.29781868801829e-05
"1753","Burnham",1,1,298,335,8,641,0.000220655744293383
"1754","Buxton",1,1,2252,2172,30,4454,0.00153323039794498
"1755","Byron",1,1,40,39,1,80,2.75389384453521e-05
"1756","Calais",1,1,878,720,14,1612,0.000554909609673844
"1757","Cambridge",1,1,175,100,8,283,9.74189947504329e-05
"1758","Camden",1,1,1153,2277,33,3463,0.00119209179795318
"1759","Canaan",1,1,460,558,12,1030,0.000354563832483908
"1760","Canton",1,1,279,286,17,582,0.000200345777189936
"1761","Cape Elizabeth",1,1,2548,3679,52,6279,0.00216146243122957
"1762","Caratunk",1,1,50,23,0,73,2.51292813313837e-05
"1763","Caribou",1,1,1863,2044,35,3942,0.00135698119189472
"1764","Carmel",1,1,832,607,11,1450,0.000499143259322006
"1765","Carrabassett Valley",1,1,181,263,5,449,0.000154562292024538
"1766","Carroll Plt",1,1,42,23,0,65,2.23753874868485e-05
"1767","Carthage",1,1,138,142,4,284,9.77632314809998e-05
"1768","Cary Plt",1,1,67,38,0,105,3.61448567095246e-05
"1769","Casco",1,1,1007,1036,21,2064,0.000710504611890083
"1770","Castine",1,1,332,483,11,826,0.00028433953944826
"1771","Castle Hill",1,1,124,89,3,216,7.43551338024505e-05
"1772","Caswell",1,1,52,107,0,159,5.47336401601372e-05
"1773","Centerville",1,1,8,7,0,15,5.16355095850351e-06
"1774","Chapman",1,1,132,125,1,258,8.88130764862604e-05
"1775","Charleston",1,1,455,207,6,668,0.00022995013601869
"1776","Charlotte",1,1,114,72,3,189,6.50607420771442e-05
"1777","Chelsea",1,1,671,660,16,1347,0.000463686876073615
"1778","Cherryfield",1,1,360,295,5,660,0.000227196242174154
"1779","Chester",1,1,176,101,9,286,9.84517049421336e-05
"1780","Chesterville",1,1,306,383,7,696,0.000239588764474563
"1781","China",1,1,1206,1114,22,2342,0.000806202422987681
"1782","Clifton",1,1,220,224,2,446,0.000153529581832838
"1783","Clinton",1,1,837,837,13,1687,0.000580727364466361
"1784","Codyville Plt",1,1,5,5,0,10,3.44236730566901e-06
"1785","Columbia",1,1,142,94,2,238,8.19283418749224e-05
"1786","Columbia Falls",1,1,183,147,1,331,0.000113942357817644
"1787","Connor Twp",1,1,56,150,1,207,7.12570032273484e-05
"1788","Cooper",1,1,38,56,1,95,3.27024894038556e-05
"1789","Coplin Plt",1,1,40,54,0,94,3.23582526732887e-05
"1790","Corinna",1,1,647,451,14,1112,0.000382791244390394
"1791","Corinth",1,1,920,523,24,1467,0.000504995283741643
"1792","Cornish",1,1,377,431,10,818,0.000281585645603725
"1793","Cornville",1,1,366,314,26,706,0.000243031131780232
"1794","Cranberry Isles",2,2,51,119,1,171,5.886448092694e-05
"1795","Crawford",1,1,43,13,1,57,1.96214936423133e-05
"1796","Crystal",1,1,90,56,3,149,5.12912728544682e-05
"1797","Cumberland",2,2,2428,2504,44,4976,0.0017129219713009
"1798","Cushing",1,1,384,397,8,789,0.000271602780417285
"1799","Cutler",1,1,164,97,5,266,9.15669703307956e-05
"1800","Cyr Plt",1,1,11,36,0,47,1.61791263366443e-05
"1801","Dallas Plt",1,1,108,109,0,217,7.46993705330174e-05
"1802","Damariscotta",1,1,598,770,19,1387,0.000477456345296291
"1803","Danforth",1,1,184,102,5,291,0.000100172888594968
"1804","Dayton",1,1,613,507,15,1135,0.000390708689193432
"1805","Deblois",1,1,22,13,0,35,1.20482855698415e-05
"1806","Dedham",1,1,530,478,11,1019,0.000350777228447672
"1807","Deer Isle",1,1,413,785,11,1209,0.000416182207255383
"1808","Denmark",1,1,348,297,8,653,0.000224786585060186
"1809","Dennistown Plt",1,1,20,1,1,22,7.57320807247181e-06
"1810","Dennysville",1,1,84,97,3,184,6.33395584243097e-05
"1811","Detroit",1,1,201,212,0,413,0.00014216976972413
"1812","Dexter",1,1,1039,871,21,1931,0.000664721126724685
"1813","Dixfield",1,1,545,748,22,1315,0.000452671300695474
"1814","Dixmont",1,1,350,300,7,657,0.000226163531982454
"1815","Dover-Foxcroft",1,1,1248,1046,34,2328,0.000801383108759745
"1816","Dresden",1,1,458,517,13,988,0.000340105889800098
"1817","Drew Plt",1,1,21,3,0,24,8.26168153360562e-06
"1819","Durham",1,1,1171,1129,23,2323,0.00079966192510691
"1820","Dyer Brook",1,1,83,57,1,141,4.8537379009933e-05
"1821","Eagle Lake",1,1,162,326,6,494,0.000170052944900049
"1822","East Machias",1,1,383,297,5,685,0.000235802160438327
"1823","East Millinocket",1,1,474,640,11,1125,0.000387266321887763
"1824","Eastbrook",1,1,126,99,7,232,7.98629214915209e-05
"1825","Easton",1,1,397,294,10,701,0.000241309948127397
"1826","Eastport",1,1,370,536,8,914,0.000314632371738147
"1827","Eddington",1,1,683,589,11,1283,0.000441655725317334
"1828","Edgecomb",1,1,363,421,3,787,0.000270914306956151
"1829","Edinburg",1,1,43,51,2,96,3.30467261344225e-05
"1830","Edmunds Twp",1,1,92,74,6,172,5.92087176575069e-05
"1831","Eliot",1,1,1721,2164,27,3912,0.00134665408997772
"1832","Ellsworth",4,4,2096,1896,53,4045,0.00139243757514311
"1833","Embden",1,1,265,224,6,495,0.000170397181630616
"1834","Enfield",1,1,439,401,16,856,0.000294666641365267
"1835","Etna",1,1,301,249,5,555,0.00019105138546463
"1836","Eustis",1,1,184,199,9,392,0.000134940798382225
"1837","Exeter",1,1,329,238,5,572,0.000196903409884267
"1838","Fairfield",1,1,1492,1917,41,3450,0.00118761672045581
"1839","Falmouth",1,1,3305,3683,68,7056,0.00242893437088005
"1840","Farmingdale",1,1,807,879,15,1701,0.000585546678694298
"1841","Farmington",1,1,1540,2484,48,4072,0.00140173196686842
"1842","Fayette",1,1,291,402,12,705,0.000242686895049665
"1843","Fort Fairfield",1,1,858,983,15,1856,0.000638903371932168
"1844","Fort Kent",1,1,624,1655,27,2306,0.000793809900687273
"1845","Frankfort",1,1,282,289,3,574,0.000197591883345401
"1846","Franklin",1,1,425,345,10,780,0.000268504649842183
"1847","Freedom",1,1,178,216,7,401,0.000138038928957327
"1848","Freeman Twp",1,1,49,40,1,90,3.09813057510211e-05
"1849","Freeport",1,1,1906,3007,64,4977,0.00171326620803146
"1850","Frenchboro",1,1,24,20,0,44,1.51464161449436e-05
"1851","Frenchville",1,1,156,511,3,670,0.000230638609479823
"1852","Friendship",1,1,461,301,11,773,0.000266094992728214
"1853","Frye Island",1,1,55,29,0,84,2.89158853676197e-05
"1854","Fryeburg",1,1,836,873,17,1726,0.000594152596958471
"1855","Gardiner",4,4,1483,1716,46,3245,0.00111704819068959
"1856","Garfield Plt",1,1,32,29,0,61,2.09984405645809e-05
"1857","Garland",1,1,321,236,14,571,0.0001965591731537
"1858","Georgetown",1,1,340,438,4,782,0.000269193123303316
"1859","Gilead",1,1,45,60,2,107,3.68333301706584e-05
"1860","Glenburn",1,1,1296,1047,17,2360,0.000812398684137886
"1862","Gorham",4,4,4133,4393,72,8598,0.00295974740941421
"1863","Gouldsboro",1,1,552,533,13,1098,0.000377971930162457
"1864","Grand Isle",1,1,45,257,5,307,0.000105680676284038
"1865","Grand Lake Stream Plt",1,1,54,33,1,88,3.02928322898873e-05
"1866","Gray",1,1,2108,2102,51,4261,0.00146679270894556
"1867","Great Pond",1,1,17,12,3,32,1.10155753781408e-05
"1868","Greenbush",1,1,392,296,8,696,0.000239588764474563
"1869","Greene",1,1,1248,1137,25,2410,0.000829610520666231
"1870","Greenville",1,1,638,514,22,1174,0.000404133921685541
"1872","Greenwood",1,1,186,239,6,431,0.000148366030874334
"1873","Guilford",1,1,458,354,16,828,0.000285028012909394
"1874","Hallowell",5,5,562,1131,19,1712,0.000589333282730534
"1875","Hamlin",1,1,39,84,1,124,4.26853545902957e-05
"1876","Hammond",1,1,30,18,1,49,1.68675997977781e-05
"1877","Hampden",1,1,2247,1933,38,4218,0.00145199052953119
"1878","Hancock",1,1,623,593,11,1227,0.000422378468405587
"1879","Hanover",1,1,94,78,3,175,6.02414278492076e-05
"1880","Harmony",1,1,209,233,3,445,0.000153185345102271
"1881","Harpswell",3,3,1583,2004,43,3630,0.00124957933195785
"1882","Harrington",1,1,287,247,6,540,0.000185887834506126
"1883","Harrison",1,1,762,717,25,1504,0.000517732042772619
"1884","Hartford",1,1,308,282,4,594,0.000204476617956739
"1885","Hartland",1,1,534,347,13,894,0.000307747637126809
"1886","Haynesville",1,1,41,18,0,59,2.03099671034471e-05
"1887","Hebron",1,1,317,308,10,635,0.000218590323909982
"1888","Hermon",1,1,1636,1114,34,2784,0.000958355057898251
"1889","Hersey",1,1,24,8,0,32,1.10155753781408e-05
"1890","Highland Plt",1,1,77,56,6,139,4.78489055487992e-05
"1891","Hiram",2,2,559,648,16,1223,0.00042100152148332
"1892","Hodgdon",1,1,441,212,4,657,0.000226163531982454
"1893","Holden",1,1,1119,856,12,1987,0.000683998383636432
"1894","Hollis",1,1,1154,1170,24,2348,0.000808267843371083
"1895","Hope",1,1,439,456,13,908,0.000312566951354746
"1896","Houlton",1,1,1696,1189,31,2916,0.00100379430633308
"1897","Howland",1,1,353,382,6,741,0.000255079417350073
"1898","Hudson",1,1,448,273,6,727,0.000250260103122137
"1899","Indian Purchase T3&T4Twp",1,1,21,23,2,46,1.58348896060774e-05
"1900","Indian Township Vtng Dst",1,1,38,240,0,278,9.56978110975984e-05
"1901","Industry",1,1,240,264,3,507,0.000174528022397419
"1902","Island Falls",1,1,264,184,7,455,0.00015662771240794
"1903","Isle Au Haut",1,1,14,37,1,52,1.79003099894788e-05
"1904","Islesboro",1,1,151,318,6,475,0.000163512447019278
"1905","Jackman",1,1,280,234,6,520,0.000179003099894788
"1906","Jackson",1,1,141,135,5,281,9.67305212892991e-05
"1907","Jay",1,1,974,1790,31,2795,0.000962141661934487
"1908","Jefferson",1,1,808,677,14,1499,0.000516010859119784
"1909","Jonesboro",1,1,180,135,10,325,0.000111876937434243
"1910","Jonesport",1,1,310,347,6,663,0.000228228952365855
"1911","Kenduskeag",1,1,357,319,9,685,0.000235802160438327
"1912","Kennebunk",1,1,3328,3709,71,7108,0.00244683468086953
"1913","Kennebunkport",1,1,1360,1308,27,2695,0.000927717988877797
"1914","Kingfield",1,1,405,383,12,800,0.000275389384453521
"1915","Kingman Twp",1,1,58,22,2,82,2.82274119064859e-05
"1916","Kingsbury Plt",1,1,8,5,0,13,4.47507749736971e-06
"1917","Kittery",1,1,1901,3176,36,5113,0.00176008240338856
"1918","Knox",1,1,252,172,7,431,0.000148366030874334
"1919","LaGrange",1,1,175,162,6,343,0.000118073198584447
"1920","Lake View Plt",1,1,46,30,1,77,2.65062282536514e-05
"1921","Lakeville",1,1,37,47,1,85,2.92601220981866e-05
"1922","Lamoine",1,1,514,520,13,1047,0.000360415856903545
"1923","Lebanon",1,1,1552,1237,28,2817,0.000969714870006959
"1924","Lee",1,1,313,186,3,502,0.000172806838744584
"1925","Leeds",1,1,540,582,22,1144,0.000393806819768534
"1926","Levant",1,1,822,431,9,1262,0.000434426753975429
"1927","Lewiston",8,8,6460,10867,191,17518,0.00603033904607097
"1928","Liberty",1,1,265,295,6,566,0.000194837989500866
"1929","Limerick",1,1,711,711,20,1442,0.000496389365477471
"1930","Limestone",1,1,441,574,14,1029,0.000354219595753341
"1931","Limington",1,1,1063,857,23,1943,0.000668851967491488
"1932","Lincoln",1,1,1461,1082,31,2574,0.000886065344479202
"1933","Lincoln Plt",1,1,22,8,0,30,1.0327101917007e-05
"1934","Lincolnville",1,1,629,797,20,1446,0.000497766312399738
"1935","Linneus",1,1,323,111,2,436,0.000150087214527169
"1936","Lisbon",2,2,2374,2372,65,4811,0.00165612291075736
"1937","Litchfield",1,1,969,913,23,1905,0.000655770971729946
"1938","Littleton",1,1,543,139,5,687,0.000236490633899461
"1939","Livermore",1,1,555,720,17,1292,0.000444753855892436
"1940","Livermore Falls",1,1,577,906,15,1498,0.000515666622389217
"1941","Long Island",1,1,74,128,4,206,7.09127664967815e-05
"1942","Lovell",1,1,367,333,7,707,0.000243375368510799
"1943","Lowell",1,1,111,83,0,194,6.67819257299787e-05
"1944","Lubec",1,1,343,572,2,917,0.000315665081929848
"1945","Ludlow",1,1,124,83,0,207,7.12570032273484e-05
"1946","Lyman",1,1,1105,1174,32,2311,0.000795531084340107
"1947","Machias",1,1,506,558,16,1080,0.000371775669012253
"1948","Machiasport",1,1,250,213,6,469,0.000161447026635876
"1949","Macwahoc Plt",1,1,25,33,0,58,1.99657303728802e-05
"1950","Madawaska",1,1,552,1601,24,2177,0.000749403362444143
"1951","Madawaska Lake Twp",1,1,46,50,1,97,3.33909628649894e-05
"1952","Madison",1,1,1063,1303,22,2388,0.000822037312593759
"1953","Madrid Twp",1,1,41,63,2,106,3.64890934400915e-05
"1954","Magalloway Plt",1,1,14,4,0,18,6.19626115020421e-06
"1955","Manchester",1,1,803,798,15,1616,0.000556286556596111
"1956","Mapleton",1,1,594,458,12,1064,0.000366267881323182
"1957","Mariaville",1,1,144,93,2,239,8.22725786054893e-05
"1958","Mars Hill",1,1,587,237,9,833,0.000286749196562228
"1959","Marshfield",1,1,174,101,1,276,9.50093376364646e-05
"1960","Masardis",1,1,74,73,2,149,5.12912728544682e-05
"1961","Matinicus Isle Plt",1,1,21,33,1,55,1.89330201811795e-05
"1962","Mattawamkeag",1,1,230,204,7,441,0.000151808398180003
"1963","Maxfield",1,1,31,23,2,56,1.92772569117464e-05
"1964","Mechanic Falls",1,1,820,702,20,1542,0.000530813038534161
"1965","Meddybemps",1,1,57,41,0,98,3.37351995955563e-05
"1966","Medford",1,1,89,40,2,131,4.5095011704264e-05
"1967","Medway",1,1,480,312,1,793,0.000272979727339552
"1968","Mercer",1,1,181,205,6,392,0.000134940798382225
"1969","Merrill",1,1,68,62,2,132,4.54392484348309e-05
"1970","Mexico",1,1,467,962,31,1460,0.000502585626627675
"1971","Milbridge",1,1,369,357,5,731,0.000251637050044404
"1972","Milford",1,1,675,944,21,1640,0.000564548238129717
"1973","Millinocket",1,1,1188,1647,0,2835,0.000975911131157163
"1974","Milo",1,1,616,628,19,1263,0.000434770990705996
"1975","Milton Twp",1,1,36,50,1,87,2.99485955593204e-05
"1976","Minot",1,1,789,637,18,1444,0.000497077838938605
"1977","Monhegan Plt",1,1,12,55,6,73,2.51292813313837e-05
"1978","Monmouth",2,2,1105,1075,23,2203,0.000758353517438882
"1979","Monroe",1,1,237,285,5,527,0.000181412757008757
"1980","Monson",1,1,225,239,5,469,0.000161447026635876
"1981","Monticello",1,1,286,163,3,452,0.000155595002216239
"1982","Montville",1,1,223,353,15,591,0.000203443907765038
"1983","Moose River",1,1,87,41,0,128,4.40623015125633e-05
"1984","Moro Plt",1,1,28,1,2,31,1.06713386475739e-05
"1985","Morrill",1,1,288,204,4,496,0.000170741418361183
"1986","Moscow",1,1,126,137,2,265,9.12227336002287e-05
"1987","Mount Chase",1,1,101,29,2,132,4.54392484348309e-05
"1988","Mount Desert",1,1,533,950,20,1503,0.000517387806042052
"1989","Mount Vernon",1,1,417,513,9,939,0.00032323829000232
"1990","Naples",1,1,1093,979,30,2102,0.000723585607651625
"1991","Nashville Plt",1,1,12,18,0,30,1.0327101917007e-05
"1992","New Canada",1,1,54,104,1,159,5.47336401601372e-05
"1993","New Gloucester",1,1,1555,1438,36,3029,0.00104269305688714
"1994","New Limerick",1,1,189,131,2,322,0.000110844227242542
"1995","New Portland",1,1,266,207,3,476,0.000163856683749845
"1996","New Sharon",1,1,377,424,27,828,0.000285028012909394
"1997","New Sweden",1,1,175,200,3,378,0.000130121484154288
"1998","New Vineyard",1,1,241,213,3,457,0.000157316185869074
"1999","Newburgh",1,1,469,402,7,878,0.000302239849437739
"2000","Newcastle",1,1,463,683,12,1158,0.000398626133996471
"2001","Newfield",1,1,427,332,9,768,0.00026437380907538
"2002","Newport",1,1,947,656,14,1617,0.000556630793326678
"2003","Newry",1,1,105,131,5,241,8.29610520666231e-05
"2004","Nobleboro",1,1,524,587,12,1123,0.000386577848426629
"2005","Norridgewock",1,1,814,923,24,1761,0.000606200882528312
"2006","North Berwick",1,1,1343,1177,37,2557,0.000880213320059565
"2007","North Haven",1,1,108,157,3,268,9.22554437919294e-05
"2008","North Yarmouth",1,1,1069,1207,20,2296,0.000790367533381604
"2009","Northfield",1,1,45,43,0,88,3.02928322898873e-05
"2010","Northport",1,1,435,499,13,947,0.000325992183846855
"2011","Norway",1,1,1128,1466,37,2631,0.000905686838121516
"2012","Oakfield",1,1,217,153,7,377,0.000129777247423722
"2013","Oakland",1,1,1501,1716,42,3259,0.00112186750491753
"2014","Ogunquit",1,1,408,604,7,1019,0.000350777228447672
"2015","Old Orchrd Bch",1,1,2095,3240,51,5386,0.00185405903083333
"2016","Old Town",4,4,1674,2729,41,4444,0.00152978803063931
"2017","Orient",1,1,50,30,1,81,2.7883175175919e-05
"2018","Orland",1,1,548,749,15,1312,0.000451638590503774
"2020","Orono",4,4,1576,3649,49,5274,0.00181550451700983
"2021","Orrington",1,1,1248,1017,17,2282,0.000785548219153667
"2022","Osborn",1,1,37,14,0,51,1.75560732589119e-05
"2023","Otis",1,1,245,138,2,385,0.000132531141268257
"2024","Otisfield",1,1,505,491,17,1013,0.00034871180806427
"2025","Owls Head",1,1,516,511,7,1034,0.000355940779406175
"2026","Oxbow Plt",1,1,23,21,0,44,1.51464161449436e-05
"2027","Oxford",1,1,1028,952,23,2003,0.000689506171325502
"2028","Palermo",1,1,435,336,13,784,0.00026988159676445
"2029","Palmyra",1,1,622,438,9,1069,0.000367989064976017
"2030","Paris",1,1,1274,1374,34,2682,0.000923242911380428
"2031","Parkman",1,1,254,163,7,424,0.000145956373760366
"2032","Parsonsfield",2,2,475,516,22,1013,0.00034871180806427
"2033","Passadumkeag",1,1,131,73,4,208,7.16012399579153e-05
"2034","Patten",1,1,403,193,4,600,0.00020654203834014
"2035","Pembroke",1,1,224,264,3,491,0.000169020234708348
"2036","Penobscot",1,1,359,505,5,869,0.000299141718862637
"2037","Penobscot Nation Vot Dst",1,1,24,258,2,284,9.77632314809998e-05
"2038","Perham",1,1,144,102,0,246,8.46822357194576e-05
"2039","Perkins Twp",1,1,7,5,0,12,4.13084076680281e-06
"2040","Perry",1,1,207,197,4,408,0.000140448586071295
"2041","Peru",1,1,386,535,12,933,0.000321172869618918
"2042","Phillips",1,1,281,271,4,556,0.000191395622195197
"2043","Phippsburg",1,1,676,713,22,1411,0.000485718026829897
"2044","Pittsfield",1,1,1087,986,17,2090,0.000719454766884822
"2045","Pittston",1,1,815,766,17,1598,0.000550090295445907
"2046","Pleasant Point Votng Dst",1,1,46,214,0,260,8.95015499473942e-05
"2047","Pleasant Ridge Plt",1,1,28,29,1,58,1.99657303728802e-05
"2048","Plymouth",1,1,430,279,3,712,0.000245096552163633
"2049","Poland",1,1,1465,1490,33,2988,0.0010285793509339
"2050","Portage Lake",1,1,135,136,0,271,9.32881539836301e-05
"2051","Porter",1,1,415,383,8,806,0.000277454804836922
"2052","Portland",18,18,9438,26754,384,36576,0.012590802657215
"2053","Pownal",1,1,445,557,9,1011,0.000348023334603137
"2054","Prentiss Twp",1,1,51,31,0,82,2.82274119064859e-05
"2055","Presque Isle",1,1,2268,2309,57,4634,0.00159519300944702
"2056","Princeton",1,1,258,182,5,445,0.000153185345102271
"2057","Prospect",1,1,200,184,5,389,0.000133908088190524
"2058","Randolph",1,1,486,585,8,1079,0.000371431432281686
"2059","Rangeley",1,1,440,295,13,748,0.000257489074464042
"2060","Rangeley Plt",1,1,63,44,0,107,3.68333301706584e-05
"2061","Raymond",1,1,1335,1314,33,2682,0.000923242911380428
"2062","Readfield",1,1,725,893,27,1645,0.000566269421782552
"2063","Reed Plt",1,1,60,21,1,82,2.82274119064859e-05
"2064","Richmond",1,1,895,935,29,1859,0.000639936082123868
"2065","Ripley",1,1,153,116,3,272,9.3632390714197e-05
"2066","Robbinston",1,1,131,151,4,286,9.84517049421336e-05
"2067","Rockland",1,1,1497,2077,47,3621,0.00124648120138275
"2068","Rockport",1,1,872,1224,18,2114,0.000727716448418428
"2069","Rockwood Twp",1,1,146,71,6,223,7.67647909164189e-05
"2070","Rome",1,1,283,312,10,605,0.000208263221992975
"2071","Roque Bluffs",1,1,67,93,0,160,5.50778768907041e-05
"2072","Roxbury",1,1,89,173,4,266,9.15669703307956e-05
"2073","Rumford",1,1,1151,2060,58,3269,0.0011253098722232
"2074","Sabattus",1,1,1212,1269,27,2508,0.000863345720261787
"2075","Saco",7,7,3939,5884,76,9899,0.00340759939588175
"2076","Saint Agatha",1,1,123,377,0,500,0.00017211836528345
"2077","Sandy River Plt",1,1,60,37,0,97,3.33909628649894e-05
"2078","Sanford",7,7,4634,5583,109,10326,0.00355458847983382
"2079","Sangerville",1,1,363,323,7,693,0.000238556054282862
"2080","Scarborough",3,3,5569,5651,88,11308,0.00389262894925051
"2081","Searsmont",1,1,357,377,4,738,0.000254046707158373
"2082","Searsport",1,1,724,756,9,1489,0.000512568491814115
"2083","Sebago",1,1,554,498,10,1062,0.000365579407862048
"2084","Sebec",1,1,242,148,2,392,0.000134940798382225
"2085","Seboeis Plt",1,1,16,18,1,35,1.20482855698415e-05
"2086","Sedgwick",1,1,286,440,5,731,0.000251637050044404
"2087","Shapleigh",1,1,743,757,21,1521,0.000523584067192256
"2088","Sherman",1,1,350,160,10,520,0.000179003099894788
"2089","Shirley",1,1,79,47,2,128,4.40623015125633e-05
"2090","Sidney",1,1,1208,1077,20,2305,0.000793465663956706
"2091","Sinclair Twp",1,1,30,110,0,140,4.81931422793661e-05
"2092","Skowhegan",1,1,1798,2511,40,4349,0.00149708554123545
"2093","Smithfield",1,1,268,297,12,577,0.000198624593537102
"2094","Smyrna",1,1,88,86,1,175,6.02414278492076e-05
"2095","Solon",1,1,256,303,9,568,0.000195526462962
"2096","Somerville",1,1,167,119,7,293,0.000100861362056102
"2097","Sorrento",1,1,77,137,3,217,7.46993705330174e-05
"2098","South Berwick",1,1,1848,2173,28,4049,0.00139381452206538
"2099","South Bristol",1,1,297,386,9,692,0.000238211817552295
"2100","South Portland",6,6,4844,8913,168,13925,0.00479349647314409
"2101","South Thomaston",1,1,454,503,12,969,0.000333565391919327
"2102","Southport",1,1,285,256,3,544,0.000187264781428394
"2103","Southwest Harbor",1,1,525,707,19,1251,0.000430640149939193
"2104","Springfield",1,1,95,84,5,184,6.33395584243097e-05
"2105","St Albans",1,1,638,380,13,1031,0.000354908069214475
"2106","St Francis",1,1,87,252,1,340,0.000117040488392746
"2107","St George",1,1,738,967,23,1728,0.000594841070419604
"2108","St John Plt",1,1,57,123,3,183,6.29953216937428e-05
"2109","Stacyville",1,1,128,84,4,216,7.43551338024505e-05
"2110","Standish",1,1,2721,2436,45,5202,0.00179071947240902
"2111","Starks",1,1,132,172,11,315,0.000108434570128574
"2112","Stetson",1,1,409,256,0,665,0.000228917425826989
"2113","Steuben",1,1,284,289,8,581,0.000200001540459369
"2114","Stockholm",1,1,45,86,0,131,4.5095011704264e-05
"2115","Stockton Springs",1,1,407,569,7,983,0.000338384706147263
"2116","Stoneham",1,1,77,99,2,178,6.12741380409083e-05
"2117","Stonington",1,1,226,474,10,710,0.000244408078702499
"2118","Stow",1,1,90,90,1,181,6.2306848232609e-05
"2119","Strong",1,1,353,309,26,688,0.000236834870630028
"2120","Sullivan",1,1,308,340,14,662,0.000227884715635288
"2121","Sumner",1,1,236,238,8,482,0.000165922104133246
"2122","Surry",1,1,418,531,7,956,0.000329090314421957
"2123","Swans Island",1,1,149,113,5,267,9.19112070613625e-05
"2124","Swanville",1,1,359,352,10,721,0.000248194682738735
"2125","Sweden",1,1,112,88,1,201,6.9191582843947e-05
"2127","T17 R5 Twp (Grt/CrossLk)",1,1,43,68,0,111,3.8210277092926e-05
"2128","T3 ND Twp",1,1,2,2,0,4,1.3769469222676e-06
"2129","Talmadge",1,1,24,11,0,35,1.20482855698415e-05
"2130","Temple",1,1,132,208,10,350,0.000120482855698415
"2131","The Forks Plt",1,1,35,15,0,50,1.7211836528345e-05
"2132","Thomaston",1,1,699,826,22,1547,0.000532534222186995
"2133","Thorndike",1,1,195,214,2,411,0.000141481296262996
"2134","Topsfield",1,1,74,49,1,124,4.26853545902957e-05
"2135","Topsham",1,1,2386,2751,60,5197,0.00178899828875618
"2136","Township 14",1,1,8,4,0,12,4.13084076680281e-06
"2137","Township 21",1,1,31,20,0,51,1.75560732589119e-05
"2138","Township 27",1,1,15,9,0,24,8.26168153360562e-06
"2139","Township 8 SD",1,1,28,20,0,48,1.65233630672112e-05
"2140","Tremont",1,1,444,558,11,1013,0.00034871180806427
"2141","Trenton",1,1,391,435,11,837,0.000288126143484496
"2143","Troy",1,1,287,255,8,550,0.000189330201811795
"2144","Turner",1,1,1569,1369,37,2975,0.00102410427343653
"2145","Union",1,1,682,692,18,1392,0.000479177528949126
"2146","Unity",1,1,589,591,20,1200,0.000413084076680281
"2147","Upton",1,1,35,26,0,61,2.09984405645809e-05
"2148","Van Buren",1,1,218,955,9,1182,0.000406887815530077
"2149","Vanceboro",1,1,50,66,0,116,3.99314607457605e-05
"2150","Vassalboro",1,1,1047,1046,18,2111,0.000726683738226727
"2151","Veazie",1,1,527,524,10,1061,0.000365235171131482
"2152","Verona",1,1,175,154,3,332,0.000114286594548211
"2153","Vienna",1,1,607,442,18,1067,0.000367300591514883
"2154","Vinalhaven",1,1,249,519,7,775,0.000266783466189348
"2155","Wade",1,1,90,67,0,157,5.40451666990034e-05
"2156","Waite",1,1,31,25,3,59,2.03099671034471e-05
"2157","Waldo",1,1,205,205,6,416,0.000143202479915831
"2158","Waldoboro",1,1,1387,1348,29,2764,0.000951470323286913
"2159","Wales",1,1,457,300,11,768,0.00026437380907538
"2160","Wallagrass",1,1,58,244,3,305,0.000104992202822905
"2161","Waltham",1,1,139,66,2,207,7.12570032273484e-05
"2162","Warren",1,1,1029,858,23,1910,0.00065749215538278
"2163","Washburn",1,1,494,354,1,849,0.000292256984251299
"2164","Washington",1,1,419,450,13,882,0.000303616796360006
"2165","Waterboro",1,1,1713,1701,35,3449,0.00118727248372524
"2166","Waterford",1,1,439,478,15,932,0.000320828632888351
"2167","Waterville",1,1,1803,3356,71,5230,0.00180035810086489
"2168","Wayne",1,1,295,439,1,735,0.000253013996966672
"2169","Webster Plt",1,1,11,24,0,35,1.20482855698415e-05
"2170","Weld",1,1,125,152,6,283,9.74189947504329e-05
"2171","Wellington",1,1,50,99,2,151,5.1979746315602e-05
"2172","Wells",1,1,2814,2879,48,5741,0.00197626307018458
"2173","Wesley",1,1,41,30,1,72,2.47850446008168e-05
"2174","West Bath",1,1,575,602,17,1194,0.000411018656296879
"2175","West Forks Plt",1,1,24,19,0,43,1.48021794143767e-05
"2176","West Gardiner",1,1,973,897,17,1887,0.000649574710579742
"2177","West Paris",1,1,416,482,13,911,0.000313599661546446
"2178","Westbrook",6,6,3722,5016,80,8818,0.00303547949013893
"2179","Westfield",1,1,170,121,3,294,0.000101205598786669
"2180","Westmanland",1,1,29,21,0,50,1.7211836528345e-05
"2181","Weston",1,1,94,42,2,138,4.75046688182323e-05
"2182","Westport",1,1,277,269,5,551,0.000189674438542362
"2183","Whitefield",1,1,585,709,11,1305,0.000449228933389805
"2184","Whiting",1,1,159,172,4,335,0.000115319304739912
"2185","Whitneyville",1,1,65,47,2,114,3.92429872846267e-05
"2186","Willimantic",1,1,69,27,1,97,3.33909628649894e-05
"2187","Wilton",1,1,927,1220,32,2179,0.000750091835905277
"2188","Windham",3,3,4549,4393,77,9019,0.00310467107298288
"2189","Windsor",1,1,710,552,14,1276,0.000439246068203365
"2190","Winn",1,1,131,88,3,222,7.64205541858519e-05
"2191","Winslow",1,1,1799,2492,46,4337,0.00149295470046865
"2192","Winter Harbor",1,1,163,166,9,338,0.000116352014931612
"2193","Winterport",1,1,1107,1054,21,2182,0.000751124546096977
"2194","Winterville Plt",1,1,34,90,2,126,4.33738280514295e-05
"2195","Winthrop",1,1,1724,1820,49,3593,0.00123684257292687
"2196","Wiscasset",1,1,1083,1070,18,2171,0.000747337942060741
"2197","Woodland",1,1,338,306,6,650,0.000223753874868485
"2198","Woodstock",1,1,422,344,2,768,0.00026437380907538
"2199","Woodville",1,1,66,59,1,126,4.33738280514295e-05
"2200","Woolwich",1,1,922,920,19,1861,0.000640624555585002
"2201","Yarmouth",1,1,2327,3185,41,5553,0.001911546564838
"2202","York",1,1,3793,4647,73,8513,0.00293048728731603
"2203","Alcona",22,22,3590,2871,29,6490,0.00223409638137919
"2204","Alger",13,13,2316,2395,30,4741,0.00163202633961768
"2205","Allegan",45,45,32952,19227,301,52480,0.0180655436201509
"2206","Alpena",20,20,7665,7406,78,15149,0.00521484223135798
"2207","Antrim",16,16,8379,5072,89,13540,0.00466096533187584
"2208","Arenac",18,18,4071,4076,42,8189,0.00281895458661235
"2209","Baraga",9,9,1977,1660,20,3657,0.00125887372368316
"2210","Barry",25,25,18638,11312,181,30131,0.0103721969287113
"2211","Bay",75,75,25443,31041,345,56829,0.0195626291613864
"2212","Benzie",22,22,5283,4383,53,9719,0.00334563678437971
"2213","Berrien",73,73,41069,32830,384,74283,0.0255709370567011
"2214","Branch",29,29,10784,7004,93,17881,0.00615529697926675
"2215","Calhoun",61,61,31643,29482,363,61488,0.0211664280890976
"2216","Cass",23,23,12915,9522,83,22520,0.0077522111723666
"2217","Charlevoix",21,21,8214,5729,95,14038,0.00483239522369815
"2218","Cheboygan",21,21,7795,5941,70,13806,0.00475253230220663
"2219","Chippewa",20,20,9122,7203,100,16425,0.00565408829956134
"2220","Clare",27,27,7087,6981,78,14146,0.00486957279059938
"2221","Clinton",32,32,21976,15473,168,37617,0.0129491530937351
"2222","Crawford",11,11,4017,3126,43,7186,0.00247368514585375
"2223","Delta",26,26,9678,9381,105,19164,0.00659695270458408
"2224","Dickinson",16,16,7688,5624,107,13419,0.00461931268747724
"2225","Eaton",68,68,29777,25410,283,55470,0.019094811444546
"2226","Emmet",23,23,10329,6845,119,17293,0.00595288578169341
"2227","Genesee",228,228,83890,128382,916,213188,0.0733871401160964
"2228","Gladwin",21,21,6770,6343,66,13179,0.00453669587214118
"2229","Gogebic",12,12,3935,4421,59,8415,0.00289675208772047
"2230","Grand Traverse",40,40,27446,18255,258,45959,0.0158207759001242
"2231","Gratiot",25,25,9831,7377,85,17293,0.00595288578169341
"2232","Hillsdale",36,36,12804,7123,106,20033,0.00689609442344672
"2233","Houghton",34,34,8889,6731,125,15745,0.00542000732277585
"2234","Huron",31,31,9670,7629,106,17405,0.00599144029551691
"2235","Ingham",159,159,54713,76826,783,132322,0.0455500926620734
"2236","Ionia",48,48,16589,10645,180,27414,0.00943690573176102
"2237","Iosco",20,20,7294,6555,97,13946,0.004800725444486
"2238","Iron",16,16,3224,3135,42,6401,0.00220345931235873
"2239","Isabella",28,28,11754,12334,143,24231,0.00834120021836657
"2240","Jackson",82,82,39713,31013,412,71138,0.0244883125390682
"2241","Kalamazoo",138,138,57139,61425,620,119184,0.0410275104958855
"2242","Kalkaska",22,22,5088,3185,44,8317,0.00286301688812491
"2243","Kent",285,285,171157,116814,1410,289381,0.0996155693281803
"2244","Keweenaw",5,5,781,630,16,1427,0.000491225814518967
"2245","Lake",20,20,2502,2675,33,5210,0.00179347336625355
"2246","Lapeer",37,37,25555,18084,254,43893,0.015109582814773
"2247","Leelanau",13,13,7733,6048,72,13853,0.00476871142854327
"2248","Lenawee",45,45,25669,20785,277,46731,0.0160865266561218
"2249","Livingston",81,81,58854,33980,416,93250,0.0321000751253635
"2250","Luce",4,4,1749,1045,19,2813,0.000968337923084692
"2251","Mackinac",15,15,3687,2793,48,6528,0.00224717737714073
"2252","Macomb",426,426,201283,195683,2077,399043,0.137365257675608
"2253","Manistee",25,25,6286,6269,82,12637,0.00435011956417392
"2254","Marquette",40,40,14689,17409,229,32327,0.0111281407890362
"2255","Mason",26,26,8124,6333,82,14539,0.00500485782571217
"2256","Mecosta",22,22,9710,7730,70,17510,0.00602758515222643
"2257","Menominee",20,20,5945,5327,97,11369,0.00391362738981509
"2258","Midland",50,50,24369,18355,219,42943,0.0147825579207344
"2259","Missaukee",17,17,5055,2319,20,7394,0.00254528638581166
"2260","Monroe",70,70,37469,36086,339,73894,0.0254370289685106
"2261","Montcalm",29,29,14967,11466,183,26616,0.00916220482076863
"2262","Montmorency",9,9,3300,2196,37,5533,0.00190466183022666
"2263","Muskegon",92,92,35943,45248,391,81582,0.0280835209531089
"2264","Newaygo",30,30,13607,9054,101,22762,0.00783551646116379
"2265","Oakland",605,605,316567,319607,2768,638942,0.219947305101877
"2266","Oceana",29,29,6677,5441,73,12191,0.00419658998234109
"2267","Ogemaw",25,25,5454,5213,71,10738,0.00369641401282738
"2268","Ontonagon",14,14,2267,1863,30,4160,0.00143202479915831
"2269","Osceola",24,24,6599,4467,62,11128,0.00383066633774847
"2270","Oscoda",9,9,2570,1792,33,4395,0.00151292043084153
"2271","Otsego",14,14,7470,4674,88,12232,0.00421070368829433
"2272","Ottawa",108,108,92039,35551,545,128135,0.0441087734711898
"2273","Presque Isle",18,18,3982,3432,45,7459,0.00256766177329851
"2274","Roscommon",14,14,7364,6810,119,14293,0.00492017558999271
"2275","Saginaw",90,90,47157,54865,446,102468,0.0352732493077292
"2276","Sanilac",30,30,12632,7883,145,20660,0.00711193085351217
"2277","Schoolcraft",12,12,2267,2137,20,4424,0.00152290329602797
"2278","Shiawassee",36,36,19405,16881,205,36491,0.0125615425351168
"2279","St Clair",77,77,42739,36174,435,79348,0.0273144960970224
"2280","St Joseph",26,26,15339,9645,138,25122,0.00864791514530168
"2281","Tuscola",31,31,15388,12631,193,28212,0.0097116066427534
"2282","Van Buren",53,53,17631,16152,184,33967,0.0116926890271659
"2283","Washtenaw",152,152,61425,109872,923,172220,0.0592844497382316
"2284","Wayne",1402,1402,257267,596208,3616,857091,0.295042203638315
"2285","Wexford",20,20,4494,2998,2,7494,0.00257971005886835
"2286","Aitkin",54,54,4768,4539,75,9382,0.00322962900617866
"2287","Anoka",121,121,91853,80226,978,173057,0.0595725758817161
"2288","Becker",46,46,9795,6756,143,16694,0.00574668798008384
"2289","Beltrami",62,62,10003,10285,125,20413,0.00702690438106214
"2290","Benton",31,31,10053,8059,140,18252,0.00628300880630707
"2291","Big Stone",23,23,1483,1536,26,3045,0.00104820084457621
"2292","Blue Earth",54,54,15737,16865,276,32878,0.0113178152275786
"2293","Brown",32,32,8405,5159,117,13681,0.00470950271088577
"2294","Carlton",39,39,6643,11464,118,18225,0.00627371441458176
"2295","Carver",34,34,28510,16456,222,45188,0.0155553693808571
"2296","Cass",72,72,8813,6764,112,15689,0.0054007300658641
"2297","Chippewa",23,23,3089,3424,46,6559,0.0022578487157883
"2298","Chisago",23,23,15705,12219,166,28090,0.00966960976162424
"2299","Clay",54,54,14365,12989,201,27555,0.00948544311077095
"2300","Clearwater",29,29,2438,1871,34,4343,0.00149502012085205
"2301","Cook",12,12,1489,1733,41,3263,0.0011232444518398
"2302","Cottonwood",28,28,3558,2727,50,6335,0.00218073968814132
"2303","Crow Wing",59,59,19106,14005,259,33370,0.0114871796990175
"2304","Dakota",137,137,108923,104609,1109,214641,0.0738873160856101
"2305","Dodge",19,19,5593,4118,87,9798,0.00337283148609449
"2306","Douglas",37,37,11793,8219,195,20207,0.00695599161456536
"2307","Faribault",33,33,4794,3770,59,8623,0.00296835332767838
"2308","Fillmore",37,37,5694,5825,91,11610,0.00399658844188172
"2309","Freeborn",40,40,7681,9733,136,17550,0.00604135462144911
"2310","Goodhue",44,44,13135,12100,209,25444,0.00875875937254422
"2311","Grant",23,23,1893,1856,31,3780,0.00130121484154288
"2312","Hennepin",430,430,255112,383823,4008,642943,0.221324596260875
"2313","Houston",27,27,5631,5276,93,11000,0.00378660403623591
"2314","Hubbard",34,34,6444,4741,92,11277,0.00388195761060294
"2315","Isanti",17,17,11093,7568,112,18773,0.00646235614293243
"2316","Itasca",80,80,10705,13290,171,24166,0.00831882483087972
"2317","Jackson",30,30,3033,2657,62,5752,0.00198004967422081
"2318","Kanabec",20,20,4527,3592,58,8177,0.00281482374584555
"2319","Kandiyohi",47,47,11704,9337,155,21196,0.00729644174109603
"2320","Kittson",37,37,1307,1333,26,2666,0.000917735123691357
"2321","Koochiching",35,35,3489,3662,54,7205,0.00248022564373452
"2322","Lac Qui Parle",31,31,2093,2390,36,4519,0.00155560578543182
"2323","Lake",18,18,2769,4212,43,7024,0.00241791879550191
"2324","Lake of the Woods",15,15,1428,921,27,2376,0.000817906471826956
"2325","Le Sueur",27,27,7746,6466,103,14315,0.00492774879806518
"2326","Lincoln",20,20,1737,1557,27,3321,0.00114321018221268
"2327","Lyon",33,33,7202,5292,88,12582,0.00433118654399274
"2328","Mahnomen",19,19,1132,1339,18,2489,0.000856805222381016
"2329","Marshall",60,60,3187,2308,36,5531,0.00190397335676553
"2330","Martin",37,37,6311,4590,67,10968,0.00377558846085777
"2331","McLeod",28,28,11409,6713,132,18254,0.0062836972797682
"2332","Meeker",30,30,6854,5292,94,12240,0.00421345758213886
"2333","Mille Lacs",25,25,7194,5667,110,12971,0.00446509463218327
"2334","Morrison",48,48,9698,6794,147,16639,0.00572775495990266
"2335","Mower",39,39,7591,12334,153,20078,0.00691158507632223
"2336","Murray",29,29,2719,2218,34,4971,0.00171120078764806
"2337","Nicollet",33,33,8688,8797,130,17615,0.00606373000893596
"2338","Nobles",40,40,5159,3898,67,9124,0.0031408159296924
"2339","Norman",33,33,1794,1954,28,3776,0.00129983789462062
"2340","Olmsted",75,75,37370,33287,482,71139,0.0244886567757987
"2341","Otter Tail",91,91,19737,12042,217,31996,0.0110141984312186
"2342","Pennington",34,34,3767,3117,75,6959,0.00239554340801506
"2343","Pine",47,47,7033,7128,119,14280,0.00491570051249534
"2344","Pipestone",22,22,3066,1900,46,5012,0.00172531449360131
"2345","Polk",82,82,8724,6729,122,15575,0.00536148707857948
"2346","Pope",30,30,3303,3301,51,6655,0.00229089544192272
"2347","Ramsey",178,178,95074,169979,1752,266805,0.0918440808989019
"2348","Red Lake",21,21,1164,963,27,2154,0.000741485917641104
"2349","Redwood",43,43,4897,3103,71,8071,0.00277833465240546
"2350","Renville",37,37,4431,3789,77,8297,0.00285613215351357
"2351","Rice",33,33,13881,16425,255,30561,0.0105202187228551
"2352","Rock",24,24,3086,1981,35,5102,0.00175629579935233
"2353","Roseau",44,44,5355,2442,67,7864,0.00270707764917811
"2354","Scott",44,44,36055,23958,323,60336,0.0207698673754845
"2355","Sherburne",30,30,25182,15816,239,41237,0.0141952900583873
"2356","Sibley",24,24,4669,3108,96,7873,0.00271017577975321
"2357","St Louis",184,183,40105,77903,725,118733,0.0408722597303998
"2358","Stearns",103,103,42881,34171,669,77721,0.0267544229363901
"2359","Steele",26,26,10388,7992,129,18509,0.00637147764606276
"2360","Stevens",25,25,3030,2821,49,5900,0.00203099671034471
"2361","Swift",31,31,2481,3165,54,5700,0.00196214936423133
"2362","Todd",38,38,6945,5034,103,12082,0.00415906817870929
"2363","Traverse",20,20,1076,1026,26,2128,0.000732535762646365
"2364","Wabasha",33,33,6120,5548,97,11765,0.00404994513511959
"2365","Wadena",24,24,4214,2791,52,7057,0.00242927860761062
"2366","Waseca",22,22,5456,4177,92,9725,0.00334770220476311
"2367","Washington",84,84,65751,61372,661,127784,0.0439879463787608
"2368","Watonwan",21,21,2970,2514,57,5541,0.0019074157240712
"2369","Wilkin",31,31,2303,1169,26,3498,0.00120414008352302
"2370","Winona",47,47,12525,14112,130,26767,0.00921418456708423
"2371","Wright",39,39,36176,22574,352,59102,0.020345079249965
"2372","Yellow Medicine",33,33,2878,2799,44,5721,0.00196937833557324
"2373","Adair",10,10,6367,4938,0,11305,0.00389159623905881
"2374","Andrew",19,19,5135,3069,0,8204,0.00282411813757085
"2375","Atchison",6,6,2137,1005,0,3142,0.0010815918074412
"2376","Audrain",21,21,6294,4318,0,10612,0.00365304018477595
"2377","Barry",19,19,9599,4223,0,13822,0.0047580400898957
"2378","Barton",16,16,4572,1373,0,5945,0.00204648736322022
"2379","Bates",16,16,5005,3397,0,8402,0.0028922770102231
"2380","Benton",13,13,5575,3381,0,8956,0.00308298415895716
"2381","Bollinger",15,15,4102,1754,0,5856,0.00201585029419977
"2382","Boone",92,92,37515,37480,0,74995,0.0258160336088647
"2383","Buchanan",51,51,19812,17798,0,37610,0.0129467434366211
"2384","Butler",25,25,11696,4666,0,16362,0.00563240138553563
"2385","Caldwell",10,10,2593,1645,0,4238,0.00145887526414253
"2386","Callaway",28,28,11108,6559,0,17667,0.00608163031892543
"2387","Camden",26,26,13122,6296,0,19418,0.00668438883414808
"2388","Cape Girardeau",36,36,23814,10568,0,34382,0.0118355472703512
"2389","Carroll",17,17,3155,1568,0,4723,0.00162583007846747
"2390","Carter",8,8,1797,964,0,2761,0.000950437613095213
"2391","Cass",48,48,27248,16681,0,43929,0.0151219753370734
"2392","Cedar",14,14,4238,1910,0,6148,0.00211636741952531
"2393","Chariton",17,17,2419,1890,0,4309,0.00148331607201278
"2394","Christian",28,28,22101,9058,0,31159,0.0107260722877341
"2395","Clark",12,12,1899,1794,0,3693,0.00127126624598356
"2396","Clay",75,75,51033,44522,0,95555,0.0328935407893202
"2397","Clinton",9,9,5282,4164,0,9446,0.00325166015693494
"2398","Cole",41,41,24750,11753,0,36503,0.0125656733758836
"2399","Cooper",15,15,5058,2400,0,7458,0.00256731753656794
"2400","Crawford",18,18,5686,3632,0,9318,0.00320759785542238
"2401","Dade",13,13,2963,1104,0,4067,0.00140001078321558
"2402","Dallas",14,14,4788,2407,0,7195,0.00247678327642885
"2403","Daviess",12,12,2351,1402,0,3753,0.00129192044981758
"2404","DeKalb",12,12,2941,1707,0,4648,0.00160001232367495
"2405","Dent",8,8,4369,1865,0,6234,0.00214597177835406
"2406","Douglas",25,25,4498,1741,0,6239,0.00214769296200689
"2407","Dunklin",21,21,6721,4901,0,11622,0.00400071928264852
"2408","Franklin",57,57,26428,18556,0,44984,0.0154851450878215
"2409","Gasconade",22,22,4753,2355,0,7108,0.00244683468086953
"2410","Gentry",11,11,2085,1200,0,3285,0.00113081765991227
"2411","Greene",140,140,77841,46626,0,124467,0.0428461131434704
"2412","Grundy",22,22,3171,1561,0,4732,0.00162892820904257
"2413","Harrison",12,12,2729,1279,0,4008,0.00137970081611214
"2414","Henry",20,20,6357,4456,0,10813,0.0037222317676199
"2415","Hickory",12,12,2790,2043,0,4833,0.00166369611882983
"2416","Holt",7,7,1864,811,0,2675,0.000920833254266459
"2417","Howard",10,10,2915,1972,0,4887,0.00168228490228044
"2418","Howell",21,21,11093,5118,0,16211,0.00558042163922003
"2419","Iron",12,12,2477,2157,0,4634,0.00159519300944702
"2420","Jackson",704,704,129612,180944,0,310556,0.106904782097934
"2421","Jasper",68,68,31846,13002,0,44848,0.0154383288924644
"2422","Jefferson",84,84,46624,46057,0,92681,0.0319042044256709
"2423","Johnson",21,21,12194,7778,0,19972,0.00687509598288214
"2424","Knox",6,6,1205,761,0,1966,0.000676769412294527
"2425","LaClede",25,25,10576,4212,0,14788,0.00509057277162333
"2426","Lafayette",20,20,9642,6397,0,16039,0.00552121292156252
"2427","Lawrence",20,20,11194,4506,0,15700,0.00540451666990034
"2428","Lewis",11,11,2862,1754,0,4616,0.00158899674829681
"2429","Lincoln",24,24,11316,8367,0,19683,0.00677561156774831
"2430","Linn",21,21,3420,2440,0,5860,0.00201722724112204
"2431","Livingston",14,14,4029,2278,0,6307,0.00217110105968544
"2432","Macon",13,13,4673,2857,0,7530,0.00259210258116876
"2433","Madison",8,8,2905,1970,0,4875,0.00167815406151364
"2434","Maries",11,11,2825,1563,0,4388,0.00151051077372756
"2435","Marion",22,22,7815,4568,0,12383,0.00426268343460993
"2436","McDonald",18,18,5443,2215,0,7658,0.00263616488268133
"2437","Mercer",10,10,1207,582,0,1789,0.000615839510984185
"2438","Miller",21,21,7795,2956,0,10751,0.00370088909032475
"2439","Mississippi",9,9,2903,2374,0,5277,0.00181653722720153
"2440","Moniteau",15,15,4743,1913,0,6656,0.00229123967865329
"2441","Monroe",9,9,2632,1645,0,4277,0.00147230049663463
"2442","Montgomery",11,11,3561,2147,0,5708,0.00196490325807587
"2443","Morgan",11,11,5654,3053,0,8707,0.002997269213046
"2444","New Madrid",24,24,4154,3714,0,7868,0.00270845459610037
"2445","Newton",24,24,17186,6563,0,23749,0.00817527811423332
"2446","Nodaway",20,20,6226,3830,0,10056,0.00346164456258075
"2447","Oregon",16,16,2769,1823,0,4592,0.00158073506676321
"2448","Osage",20,20,4975,1673,0,6648,0.00228848578480876
"2449","Ozark",11,11,3083,1560,0,4643,0.00159829114002212
"2450","Pemiscot",17,17,3398,3381,0,6779,0.00233358079651302
"2451","Perry",19,19,5583,2621,0,8204,0.00282411813757085
"2452","Pettis",26,26,11600,5801,0,17401,0.00599006334859464
"2453","Phelps",39,39,11874,6666,0,18540,0.00638214898471034
"2454","Pike",17,17,4312,3664,0,7976,0.0027456321630016
"2455","Platte",35,35,23298,18404,0,41702,0.0143553601381009
"2456","Polk",24,24,8586,3775,0,12361,0.00425511022653746
"2457","Pulaski",10,10,8618,3550,0,12168,0.00418867253753805
"2458","Putnam",11,11,1659,771,0,2430,0.000836495255277569
"2459","Ralls",9,9,2986,2031,0,5017,0.00172703567725414
"2460","Randolph",15,15,6550,3585,0,10135,0.00348883926429554
"2461","Ray",13,13,5672,5034,0,10706,0.00368539843744924
"2462","Reynolds",14,14,1895,1449,0,3344,0.00115112762701572
"2463","Ripley",14,14,3693,1907,0,5600,0.00192772569117464
"2464","Saline",19,19,5333,4428,0,9761,0.00336009472706352
"2465","Schuyler",6,6,1124,894,0,2018,0.000694669722284006
"2466","Scotland",8,8,1352,828,0,2180,0.000750436072635843
"2467","Scott",27,27,11330,6057,0,17387,0.0059852440343667
"2468","Shannon",11,11,2086,1160,0,3246,0.00111739242742016
"2469","Shelby",9,9,2280,1200,0,3480,0.00119794382237281
"2470","St Charles",164,164,95789,66826,0,162615,0.0559780559411365
"2471","St Clair",18,18,3098,1841,0,4939,0.00170018521226992
"2472","St Francois",29,29,12087,10748,0,22835,0.00786064574249518
"2473","St Louis City",208,208,27460,115414,0,142874,0.0491824786430154
"2474","St Louis County",480,480,244388,294402,0,538790,0.18547130806214
"2475","Ste Genevieve",14,14,3791,4281,0,8072,0.00277867888913602
"2476","Stoddard",22,22,9241,3946,0,13187,0.00453944976598572
"2477","Stone",21,21,10521,4576,0,15097,0.0051969419213685
"2478","Sullivan",15,15,1880,1178,0,3058,0.00105267592207358
"2479","Taney",22,22,13550,5585,0,19135,0.00658696983939764
"2480","Texas",22,22,7234,3664,0,10898,0.00375149188971808
"2481","Vernon",34,34,5731,3206,0,8937,0.00307644366107639
"2482","Warren",25,25,7882,5461,0,13343,0.00459315069595416
"2483","Washington",19,19,4638,4455,0,9093,0.00313014459104483
"2484","Wayne",19,19,3919,2249,0,6168,0.00212325215413664
"2485","Webster",15,15,10181,4648,0,14829,0.00510468647757657
"2486","Worth",7,7,691,436,0,1127,0.000387954795348897
"2487","Wright",19,19,6090,2188,0,8278,0.0028495916556328
"2488","Adams",27,27,6487,7844,23,14354,0.00494117403055729
"2489","Alcorn",16,16,8605,5425,69,14099,0.00485339366426273
"2490","Amite",21,21,4106,2973,15,7094,0.00244201536664159
"2491","Attala",21,21,4882,3014,14,7910,0.00272291253878418
"2492","Benton",11,11,1962,2234,12,4208,0.00144854816222552
"2493","Bolivar",28,28,4722,8560,21,13303,0.00457938122673148
"2494","Calhoun",22,22,4096,2211,13,6320,0.00217557613718281
"2495","Carroll",16,16,3652,1897,4,5553,0.001911546564838
"2496","Chickasaw",18,18,4193,4078,27,8298,0.00285647639024414
"2497","Choctaw",17,17,2598,1290,5,3893,0.00134011359209694
"2498","Claiborne",19,19,941,4338,8,5287,0.0018199795945072
"2499","Clarke",33,33,5027,2377,17,7421,0.00255458077753697
"2500","Clay",15,15,4333,4732,12,9077,0.00312463680335576
"2501","Coahoma",19,19,3643,6741,13,10397,0.00357902928770407
"2502","Copiah",20,20,6316,4902,18,11236,0.0038678439046497
"2503","Covington",17,17,5010,3135,21,8166,0.00281103714180931
"2504","DeSoto",35,35,35437,13247,128,48812,0.0168028832924316
"2505","Forrest",33,33,15966,9781,106,25853,0.00889955219534608
"2506","Franklin",14,14,2883,1566,9,4458,0.00153460734486724
"2507","George",22,22,6182,1715,19,7916,0.00272497795916759
"2508","Greene",14,14,3850,1421,16,5287,0.0018199795945072
"2509","Grenada",22,22,5844,4154,16,10014,0.00344718661989694
"2510","Hancock",26,26,12332,5023,96,17451,0.00600727518512298
"2511","Harrison",61,61,38781,22555,235,61571,0.0211949997377346
"2512","Hinds",120,120,34269,51370,208,85847,0.0295516906089767
"2513","Holmes",17,17,1925,6170,7,8102,0.00278900599105303
"2514","Humphreys",13,13,1626,2975,13,4614,0.00158830827483568
"2515","Issaquena",5,5,437,510,1,948,0.000326336420577422
"2516","Itawamba",31,31,6751,2771,35,9557,0.00328987043402787
"2517","Jackson",58,58,34035,15046,174,49255,0.0169553801640727
"2518","Jasper",20,20,3808,4081,16,7905,0.00272119135513135
"2519","Jeff Davis",21,21,2668,2959,24,5651,0.00194528176443356
"2520","Jefferson",16,16,627,2798,2,3427,0.00117969927565277
"2521","Jones",48,48,19032,7344,68,26444,0.00910299610311112
"2522","Kemper",23,23,2107,2454,10,4571,0.0015735060954213
"2523","Lafayette",17,17,9004,6218,76,15298,0.00526613350421245
"2524","Lamar",40,40,16288,3876,59,20223,0.00696149940225443
"2525","Lauderdale",54,54,19395,10026,60,29481,0.0101484430538428
"2526","Lawrence",26,26,4119,2355,21,6495,0.00223581756503202
"2527","Leake",21,21,4926,3212,16,8154,0.00280690630104251
"2528","Lee",42,42,19878,9895,107,29880,0.010285793509339
"2529","Leflore",19,19,4427,7240,7,11674,0.004018619592638
"2530","Lincoln",32,32,9889,4372,28,14289,0.00491879864307044
"2531","Lowndes",22,22,13690,10408,68,24166,0.00831882483087972
"2532","Madison",42,42,24015,12942,75,37032,0.0127477746063535
"2533","Marion",24,24,7845,3828,26,11699,0.00402722551090217
"2534","Marshall",24,24,5932,8472,24,14428,0.00496664754861924
"2535","Monroe",63,63,9223,6149,44,15416,0.00530675343841934
"2536","Montgomery",18,18,2953,2422,9,5384,0.00185337055737219
"2537","Neshoba",38,38,7581,2515,14,10110,0.00348023334603137
"2538","Newton",19,19,6156,2274,11,8441,0.00290570224271521
"2539","Noxubee",21,21,1698,4293,5,5996,0.00206404343647914
"2540","Oktibbeha",25,25,9068,7015,83,16166,0.00556493098634452
"2541","Panola",27,27,6734,6540,21,13295,0.00457662733288694
"2542","Pearl River",34,34,14612,4392,60,19064,0.00656252903152739
"2543","Perry",15,15,3729,1259,5,4993,0.00171877399572053
"2544","Pike",32,32,8547,7578,41,16166,0.00556493098634452
"2545","Pontotoc",33,33,8375,2591,52,11018,0.00379280029738611
"2546","Prentiss",21,21,6503,3306,38,9847,0.00338969908589227
"2547","Quitman",11,11,1360,2032,3,3395,0.00116868370027463
"2548","Rankin",51,51,41971,10738,178,52887,0.0182056479694917
"2549","Scott",24,24,6364,3780,9,10153,0.00349503552544574
"2550","Sharkey",10,10,1115,1553,52,2720,0.00093632390714197
"2551","Simpson",31,31,6810,3262,1,10073,0.00346749658700039
"2552","Smith",18,18,5566,1493,13,7072,0.00243444215856912
"2553","Stone",17,17,4072,1502,18,5592,0.00192497179733011
"2554","Sunflower",18,18,3492,6057,18,9567,0.00329331280133354
"2555","Tallahatchie",22,22,2725,3377,11,6113,0.00210431913395546
"2556","Tate",18,18,6663,4279,30,10972,0.00377696540778003
"2557","Tippah",28,28,6048,2983,34,9065,0.00312050596258895
"2558","Tishomingo",19,19,5288,2775,56,8119,0.00279485801547267
"2559","Tunica",12,12,845,1934,6,2785,0.000958699294628818
"2560","Union",39,39,7422,2710,29,10161,0.00349778941929028
"2561","Walthall",21,21,3873,2550,15,6438,0.00221619607138971
"2562","Warren",22,22,11773,8244,40,20057,0.00690435610498033
"2563","Washington",20,20,7031,10562,38,17631,0.00606923779662503
"2564","Wayne",25,25,5333,3155,15,8503,0.00292704492001036
"2565","Webster",18,18,3668,1318,6,4992,0.00171842975898997
"2566","Wilkinson",10,10,1563,2794,4,4361,0.00150121638200225
"2567","Winston",29,29,5375,3960,17,9352,0.00321930190426166
"2568","Yalobusha",13,13,3278,2656,16,5950,0.00204820854687306
"2569","Yazoo",27,27,5672,5013,30,10715,0.00368849656802434
"2570","Beaverhead",16,16,3066,1103,41,4210,0.00144923663568665
"2571","Big Horn",20,20,2026,2213,49,4288,0.00147608710067087
"2572","Blaine",11,11,1484,1300,28,2812,0.000967993686354125
"2573","Broadwater",5,5,1778,533,26,2337,0.000804481239334847
"2574","Carbon",16,16,3341,1847,75,5263,0.0018117179129736
"2575","Carter",4,4,623,76,5,704,0.000242342658319098
"2576","Cascade",38,38,18933,13616,371,32920,0.0113322731702624
"2577","Chouteau",12,12,1921,941,37,2899,0.000997942281913445
"2578","Custer",14,14,3294,1629,70,4993,0.00171877399572053
"2579","Daniels",7,7,764,326,21,1111,0.000382447007659827
"2580","Dawson",10,10,2884,1494,63,4441,0.00152875532044761
"2581","Deer Lodge",18,18,1725,2699,81,4505,0.00155078647120389
"2582","Fallon",6,6,1178,289,16,1483,0.000510503071430714
"2583","Fergus",16,16,4425,1582,75,6082,0.00209364779530789
"2584","Flathead",40,40,25966,11566,509,38041,0.0130951094674955
"2585","Gallatin",46,46,22368,16381,570,39319,0.01353504400916
"2586","Garfield",7,7,590,52,8,650,0.000223753874868485
"2587","Glacier",16,16,1828,2641,49,4518,0.00155526154870126
"2588","Golden Valley",2,2,396,119,4,519,0.000178658863164221
"2589","Granite",4,4,1144,404,18,1566,0.000539074720067766
"2590","Hill",22,22,3505,2997,105,6607,0.00227437207885551
"2591","Jefferson",14,14,3843,1880,62,5785,0.00199140948632952
"2592","Judith Basin",4,4,943,322,7,1272,0.000437869121281098
"2593","Lake",22,22,7240,4952,201,12393,0.0042661258019156
"2594","Lewis & Clark",54,54,16432,12655,386,29473,0.0101456891599983
"2595","Liberty",4,4,734,281,10,1025,0.000352842648831073
"2596","Lincoln",14,14,5884,2320,101,8305,0.00285888604735811
"2597","Madison",6,6,2868,983,45,3896,0.00134114630228864
"2598","McCone",9,9,791,320,16,1127,0.000387954795348897
"2599","Meagher",5,5,698,247,16,961,0.000330811498074792
"2600","Mineral",6,6,1242,542,43,1827,0.000628920506745728
"2601","Missoula",101,101,23951,26937,992,51880,0.0178590015818108
"2602","Musselshell",6,6,1662,538,27,2227,0.000766615198972488
"2603","Park",15,15,4771,3199,124,8094,0.00278625209720849
"2604","Petroleum",1,1,228,55,4,287,9.87959416727005e-05
"2605","Phillips",13,13,1677,456,20,2153,0.000741141680910537
"2606","Pondera",8,8,1852,956,24,2832,0.000974878420965463
"2607","Powder River",9,9,856,154,11,1021,0.000351465701908806
"2608","Powell",12,12,1968,751,41,2760,0.000950093376364646
"2609","Prairie",4,4,546,181,6,733,0.000252325523505538
"2610","Ravalli",22,22,13224,6128,222,19574,0.00673808976411651
"2611","Richland",15,15,3110,1120,47,4277,0.00147230049663463
"2612","Roosevelt",13,13,1760,2193,52,4005,0.00137866810592044
"2613","Rosebud",12,12,1982,1520,49,3551,0.00122238463024306
"2614","Sanders",10,10,3461,1501,98,5060,0.00174183785666852
"2615","Sheridan",8,8,1159,845,20,2024,0.000696735142667407
"2616","Silver Bow",47,47,6381,9307,288,15976,0.0054995260075368
"2617","Stillwater",8,8,2856,987,52,3895,0.00134080206555808
"2618","Sweet Grass",5,5,1502,443,15,1960,0.000674703991911125
"2619","Teton",5,5,2232,1047,47,3326,0.00114493136586551
"2620","Toole",12,12,1582,690,21,2293,0.000789334823189903
"2621","Treasure",3,3,348,121,8,477,0.000164200920480412
"2622","Valley",9,9,2476,1429,59,3964,0.00136455439996719
"2623","Wheatland",5,5,705,250,9,964,0.000331844208266492
"2624","Wibaux",1,1,407,144,6,557,0.000191739858925764
"2625","Yellowstone",69,69,40863,24101,793,65757,0.0226359746918877
"2626","Alamance",37,37,32914,20334,0,53248,0.0183299174292263
"2627","Alexander",17,17,10678,4657,0,15335,0.00527887026324342
"2628","Alleghany",7,7,2844,1898,0,4742,0.00163237057634824
"2629","Anson",11,11,3788,5350,0,9138,0.00314563524392034
"2630","Ashe",17,17,7254,4453,0,11707,0.00402997940474671
"2631","Avery",19,19,5589,1772,0,7361,0.00253392657370296
"2632","Beaufort",21,21,12355,6936,0,19291,0.00664067076936608
"2633","Bertie",12,12,3018,4770,0,7788,0.00268091565765502
"2634","Bladen",17,17,6145,6009,0,12154,0.00418385322331011
"2635","Brunswick",23,23,22819,14809,0,37628,0.0129529396977713
"2636","Buncombe",71,71,51686,50903,0,102589,0.0353149019521278
"2637","Burke",31,31,16075,10153,0,26228,0.00902864096930867
"2638","Cabarrus",42,42,40270,19464,0,59734,0.0205626368636832
"2639","Caldwell",24,24,20799,9839,0,30638,0.0105467249511087
"2640","Camden",3,3,2271,1329,0,3600,0.00123925223004084
"2641","Carteret",34,34,16904,7369,0,24273,0.00835565816105038
"2642","Caswell",11,11,4873,4543,0,9416,0.00324133305501794
"2643","Catawba",40,40,39017,18520,0,57537,0.0198063487666278
"2644","Chatham",22,22,12712,12679,0,25391,0.00874051482582417
"2645","Cherokee",16,16,7382,3617,0,10999,0.00378625979950534
"2646","Chowan",6,6,2240,1780,0,4020,0.00138383165687894
"2647","Clay",9,9,3185,1620,0,4805,0.00165405749037396
"2648","Cleveland",28,28,22509,14028,0,36537,0.0125773774247228
"2649","Columbus",26,26,10585,10101,0,20686,0.00712088100850691
"2650","Craven",26,26,23389,15072,0,38461,0.0132396888943336
"2651","Cumberland",65,65,48042,44328,0,92370,0.0317971468024646
"2652","Currituck",11,11,5954,2887,0,8841,0.00304339693494197
"2653","Dare",16,16,9247,6075,0,15322,0.00527439518574605
"2654","Davidson",42,42,41780,16962,0,58742,0.0202211540269609
"2655","Davie",14,14,12343,4225,0,16568,0.00570331415203241
"2656","Duplin",19,19,9468,6780,0,16248,0.005593158398251
"2657","Durham",61,61,34124,72986,0,107110,0.0368711962110207
"2658","Edgecombe",21,21,7990,12478,0,20468,0.00704583740124332
"2659","Forsyth",101,101,74743,62333,0,137076,0.0471865940791885
"2660","Franklin",17,17,11341,9127,0,20468,0.00704583740124332
"2661","Gaston",46,46,34492,15186,0,49678,0.0171009923011025
"2662","Gates",5,5,1920,2117,0,4037,0.00138968368129858
"2663","Graham",4,4,2687,1270,0,3957,0.00136214474285323
"2664","Granville",14,14,9438,8962,0,18400,0.00633395584243097
"2665","Greene",10,10,3790,2648,0,6438,0.00221619607138971
"2666","Guilford",160,160,97905,99223,0,197128,0.067858698223192
"2667","Halifax",30,30,7996,11322,0,19318,0.00664996516109139
"2668","Harnett",22,22,20649,11289,0,31938,0.0109942327008457
"2669","Haywood",29,29,14607,11222,0,25829,0.00889129051381248
"2670","Henderson",35,35,27390,14608,0,41998,0.0144572542103487
"2671","Hertford",13,13,2827,4903,0,7730,0.00266094992728214
"2672","Hoke",13,13,5180,5663,0,10843,0.0037325588695369
"2673","Hyde",7,7,1222,1042,0,2264,0.000779351958003463
"2674","Iredell",29,29,37841,17673,0,55514,0.0191099578606909
"2675","Jackson",18,18,7283,6700,0,13983,0.00481346220351697
"2676","Johnston",34,34,31304,14384,0,45688,0.0157274877461406
"2677","Jones",7,7,2564,1837,0,4401,0.00151498585122493
"2678","Lee",13,13,11443,7319,0,18762,0.00645856953889619
"2679","Lenoir",22,22,12745,9539,0,22284,0.00767097130395281
"2680","Lincoln",29,29,19878,9318,0,29196,0.0100503355856312
"2681","Macon",15,15,9416,5465,0,14881,0.00512258678756605
"2682","Madison",12,12,5113,4178,0,9291,0.00319830346369707
"2683","Martin",13,13,5302,5055,0,10357,0.00356525981848139
"2684","McDowell",17,17,10484,5274,0,15758,0.00542448240027322
"2685","Mecklenburg",190,190,154177,167051,0,321228,0.110578476486544
"2686","Mitchell",9,9,7218,2054,0,9272,0.0031917629658163
"2687","Montgomery",14,14,5619,4212,0,9831,0.0033841912982032
"2688","Moore",23,23,24149,13186,0,37335,0.0128520783357152
"2689","Nash",26,26,13709,10167,0,23876,0.00821899617901532
"2690","New Hanover",46,46,44804,35103,0,79907,0.0275069244294093
"2691","Northampton",18,18,3163,5558,0,8721,0.00300208852727394
"2692","Onslow",23,23,25396,10996,0,36392,0.0125274630987906
"2693","Orange",43,43,20673,42683,0,63356,0.0218094623017966
"2694","Pamlico",8,8,3650,2320,0,5970,0.0020550932814844
"2695","Pasquotank",13,13,6546,6895,0,13441,0.00462688589554971
"2696","Pender",17,17,9917,6928,0,16845,0.00579866772639944
"2697","Perquimans",7,7,2964,1971,0,4935,0.00169880826534765
"2698","Person",14,14,8928,6152,0,15080,0.00519108989694886
"2699","Pitt",38,38,28099,24386,0,52485,0.0180672648038038
"2700","Polk",10,10,4846,3516,0,8362,0.00287850754100042
"2701","Randolph",40,40,37109,12575,0,49684,0.0171030577214859
"2702","Richmond",16,16,7604,8229,0,15833,0.00545030015506574
"2703","Robeson",41,41,15471,17172,0,32643,0.0112369195958953
"2704","Rockingham",31,31,22450,14068,0,36518,0.0125708369268421
"2705","Rowan",46,46,34549,16517,0,51066,0.0175787928831294
"2706","Rutherford",24,24,16190,8106,0,24296,0.00836357560585342
"2707","Sampson",23,23,12374,9389,0,21763,0.00749162396732746
"2708","Scotland",10,10,5097,6330,0,11427,0.00393359312018797
"2709","Stanly",24,24,17744,7567,0,25311,0.00871297588737882
"2710","Stokes",20,20,13404,5702,0,19106,0.0065769869742112
"2711","Surry",29,29,17241,8153,0,25394,0.00874154753601588
"2712","Swain",5,5,2591,2416,0,5007,0.00172359330994847
"2713","Transylvania",18,18,9172,5707,0,14879,0.00512189831410492
"2714","Tyrrell",6,6,850,727,0,1577,0.000542861324104002
"2715","Union",43,43,42266,17639,0,59905,0.0206215013446102
"2716","Vance",16,16,6870,8749,0,15619,0.00537663349472442
"2717","Wake",197,197,172563,162750,0,335313,0.115427050836579
"2718","Warren",14,14,2737,4973,0,7710,0.0026540651926708
"2719","Washington",6,6,2465,2931,0,5396,0.001857501398139
"2720","Watauga",20,20,12485,11064,0,23549,0.00810643076811994
"2721","Wayne",30,30,23826,14267,0,38093,0.0131130097774849
"2722","Wilkes",29,29,18935,7783,0,26718,0.00919731696728645
"2723","Wilson",25,25,16287,13924,0,30211,0.0103997358671566
"2724","Yadkin",12,12,12220,3544,0,15764,0.00542654782065662
"2725","Yancey",11,11,4769,4315,0,9084,0.00312704646046973
"2726","Adams",3,3,910,351,15,1276,0.000439246068203365
"2727","Barnes",15,15,3519,2175,64,5758,0.00198211509460421
"2728","Benson",8,8,1000,1195,26,2221,0.000764549778589086
"2729","Billings",3,3,449,99,9,557,0.000191739858925764
"2730","Bottineau",15,15,2457,1163,33,3653,0.00125749677676089
"2731","Bowman",4,4,1280,397,29,1706,0.000587267862347133
"2732","Burke",6,6,807,334,13,1154,0.000397249187074203
"2733","Burleigh",38,38,26370,11511,481,38362,0.0132056094580074
"2734","Cass",59,59,39517,25927,732,66176,0.0227802098819952
"2735","Cavalier",10,10,1530,882,28,2440,0.000839937622583238
"2736","Dickey",3,3,1889,881,34,2804,0.000965239792509589
"2737","Divide",6,6,748,483,25,1256,0.000432361333592027
"2738","Dunn",11,11,1176,569,16,1761,0.000606200882528312
"2739","Eddy",4,4,653,533,18,1204,0.000414461023602548
"2740","Emmons",11,11,1449,608,43,2100,0.000722897134190491
"2741","Foster",6,6,1215,518,20,1753,0.000603446988683777
"2742","Golden Valley",5,5,715,194,6,915,0.000314976608468714
"2743","Grand Forks",43,43,17255,12611,347,30213,0.0104004243406178
"2744","Grant",7,7,950,264,16,1230,0.000423411178597288
"2745","Griggs",7,7,903,504,14,1421,0.000489160394135566
"2746","Hettinger",3,3,1042,403,35,1480,0.000509470361239013
"2747","Kidder",9,9,901,433,20,1354,0.000466096533187583
"2748","LaMoure",9,9,1589,712,17,2318,0.000797940741454076
"2749","Logan",5,5,844,265,15,1124,0.000386922085157196
"2750","McHenry",8,8,1743,1028,36,2807,0.00096627250270129
"2751","McIntosh",6,6,1253,437,24,1714,0.000590021756191668
"2752","McKenzie",17,17,1884,840,14,2738,0.000942520168292174
"2753","McLean",16,16,2995,1651,56,4702,0.00161860110712557
"2754","Mercer",15,15,3277,1243,68,4588,0.00157935811984094
"2755","Morton",18,18,8279,4041,191,12511,0.00430674573612249
"2756","Mountrail",9,9,1520,1463,30,3013,0.00103718526919807
"2757","Nelson",7,7,1107,778,26,1911,0.000657836392113347
"2758","Oliver",7,7,789,309,15,1113,0.00038313548112096
"2759","Pembina",14,14,2461,1320,53,3834,0.0013198036249935
"2760","Pierce",9,9,1466,684,24,2174,0.000748370652252442
"2761","Ramsey",8,8,2941,1884,58,4883,0.00168090795535818
"2762","Ransom",6,6,1351,1197,40,2588,0.000890884658707139
"2763","Renville",5,5,944,494,18,1456,0.000501208679705407
"2764","Richland",18,18,5255,2820,94,8169,0.00281206985200101
"2765","Rolette",5,5,1391,2559,66,4016,0.00138245470995667
"2766","Sargent",5,5,1145,1017,28,2190,0.000753878439941513
"2767","Sheridan",6,6,725,199,12,936,0.000322205579810619
"2768","Sioux",9,9,318,801,12,1131,0.000389331742271165
"2769","Slope",6,6,345,89,5,439,0.000151119924718869
"2770","Stark",13,13,7195,3001,126,10322,0.00355321153291155
"2771","Steele",5,5,584,614,7,1205,0.000414805260333115
"2772","Stutsman",18,18,6495,3429,133,10057,0.00346198879931132
"2773","Towner",3,3,754,606,25,1385,0.000476767871835157
"2774","Traill",13,13,2539,1650,43,4232,0.00145680984375912
"2775","Walsh",18,18,3189,1905,61,5155,0.00177454034607237
"2776","Ward",32,32,16970,8223,276,25469,0.00876736529080839
"2777","Wells",6,6,1651,858,35,2544,0.000875738242562195
"2778","Williams",15,15,6264,2510,109,8883,0.00305785487762578
"2779","Adams",28,28,9119,3752,130,13001,0.00447542173410028
"2780","Antelope",14,14,2739,610,26,3375,0.00116179896566329
"2781","Arthur",1,1,238,24,2,264,9.08784968696618e-05
"2782","Banner",2,2,373,56,1,430,0.000148021794143767
"2783","Blaine",3,3,296,36,0,332,0.000114286594548211
"2784","Boone",9,9,2304,545,20,2869,0.000987615179996438
"2785","Box Butte",10,10,3396,1657,55,5108,0.00175836121973573
"2786","Boyd",3,3,904,223,5,1132,0.000389675979001732
"2787","Brown",4,4,1417,266,13,1696,0.000583825495041463
"2788","Buffalo",35,35,13888,4025,152,18065,0.00621863653769106
"2789","Burt",11,11,2327,1260,23,3610,0.00124269459734651
"2790","Butler",20,20,2994,1056,53,4103,0.00141240330551599
"2791","Cass",30,30,7120,3310,72,10502,0.00361517414441359
"2792","Cedar",20,20,3387,1083,43,4513,0.00155354036504842
"2793","Chase",8,8,1597,280,5,1882,0.000647853526926907
"2794","Cherry",21,21,2503,481,28,3012,0.0010368410324675
"2795","Cheyenne",11,11,3719,870,31,4620,0.00159037369521908
"2796","Clay",12,12,2501,738,30,3269,0.0011253098722232
"2797","Colfax",10,10,2589,990,40,3619,0.00124579272792161
"2798","Cuming",10,10,3305,964,29,4298,0.00147952946797654
"2799","Custer",31,31,4518,1040,24,5582,0.00192152943002444
"2800","Dakota",14,14,3446,2935,29,6410,0.00220655744293383
"2801","Dawes",12,12,2715,1084,38,3837,0.0013208363351852
"2802","Dawson",20,20,6025,1711,45,7781,0.00267850600054105
"2803","Deuel",4,4,812,218,5,1035,0.000356285016136742
"2804","Dixon",14,14,2015,934,22,2971,0.00102272732651426
"2805","Dodge",32,32,10111,4924,112,15147,0.00521415375789684
"2806","Douglas",342,342,100675,68415,1226,170316,0.0586290230032323
"2807","Dundy",6,6,858,186,4,1048,0.000360760093634112
"2808","Fillmore",13,13,2292,816,27,3135,0.00107918215032723
"2809","Franklin",10,10,1277,412,11,1700,0.000585202441963731
"2810","Frontier",8,8,1157,274,12,1443,0.000496733602208038
"2811","Furnas",9,9,1941,491,16,2448,0.000842691516427773
"2812","Gage",29,29,6541,3627,80,10248,0.0035277380148496
"2813","Garden",5,5,970,201,9,1180,0.000406199342068943
"2814","Garfield",2,2,805,196,12,1013,0.00034871180806427
"2815","Gosper",4,4,890,222,5,1117,0.000384512428043228
"2816","Grant",1,1,352,41,2,395,0.000135973508573926
"2817","Greeley",4,4,862,361,15,1238,0.000426165072441823
"2818","Hall",38,38,14168,6064,193,20425,0.00703103522182895
"2819","Hamilton",12,12,3724,1007,46,4777,0.00164441886191808
"2820","Harlan",9,9,1454,396,21,1871,0.000644066922890671
"2821","Hayes",3,3,524,66,2,592,0.000203788144495605
"2822","Hitchcock",6,6,1171,296,9,1476,0.000508093414316745
"2823","Holt",24,24,4080,871,25,4976,0.0017129219713009
"2824","Hooker",2,2,392,64,2,458,0.000157660422599641
"2825","Howard",8,8,2007,894,34,2935,0.00101033480421385
"2826","Jefferson",11,11,2586,1347,29,3962,0.00136386592650606
"2827","Johnson",8,8,1458,885,25,2368,0.000815152577982421
"2828","Kearney",12,12,2604,706,27,3337,0.00114871796990175
"2829","Keith",12,12,3290,736,24,4050,0.00139415875879595
"2830","Keya Paha",5,5,441,96,5,542,0.00018657630796726
"2831","Kimball",6,6,1473,362,7,1842,0.000634084057704231
"2832","Knox",19,19,3062,1086,38,4186,0.00144097495415305
"2833","Lancaster",211,211,64897,48539,917,114353,0.0393645028505168
"2834","Lincoln",28,28,10546,4665,118,15329,0.00527680484286002
"2835","Logan",1,1,316,60,1,377,0.000129777247423722
"2836","Loup",1,1,310,68,3,381,0.000131154194345989
"2837","Madison",27,27,10809,2866,93,13768,0.00473945130644509
"2838","McPherson",1,1,258,49,1,308,0.000106024913014605
"2839","Merrick",15,15,2770,833,30,3633,0.00125061204214955
"2840","Morrill",10,10,1734,494,20,2248,0.000773844170314393
"2841","Nance",6,6,1208,457,17,1682,0.000579006180813527
"2842","Nemaha",13,13,2595,1066,30,3691,0.00127057777252243
"2843","Nuckolls",9,9,1884,541,23,2448,0.000842691516427773
"2844","Otoe",20,20,4967,2252,47,7266,0.0025012240842991
"2845","Pawnee",7,7,979,477,5,1461,0.000502929863358242
"2846","Perkins",7,7,1276,261,5,1542,0.000530813038534161
"2847","Phelps",14,14,3798,825,18,4641,0.00159760266656099
"2848","Pierce",8,8,2824,546,14,3384,0.00116489709623839
"2849","Platte",31,31,10995,2609,105,13709,0.00471914133934164
"2850","Polk",7,7,1886,454,20,2360,0.000812398684137886
"2851","Red Willow",18,18,4063,1040,40,5143,0.00177040950530557
"2852","Richardson",15,15,2903,1283,26,4212,0.00144992510914779
"2853","Rock",5,5,743,130,8,881,0.000303272559629439
"2854","Saline",14,14,3031,2389,37,5457,0.00187849983870358
"2855","Sarpy",80,80,42263,18361,314,60938,0.0209770978872858
"2856","Saunders",19,19,6866,3090,82,10038,0.00345544830143055
"2857","Scotts Bluff",30,30,10131,3747,88,13966,0.00480761017909733
"2858","Seward",17,17,5257,2086,46,7389,0.00254356520215883
"2859","Sheridan",9,9,2127,429,16,2572,0.000885376871018069
"2860","Sherman",7,7,1065,536,19,1620,0.000557663503518379
"2861","Sioux",2,2,657,123,3,783,0.000269537360033883
"2862","Stanton",9,9,2147,555,14,2716,0.000934946960219702
"2863","Thayer",8,8,2043,751,18,2812,0.000967993686354125
"2864","Thomas",3,3,378,60,4,442,0.00015215263491057
"2865","Thurston",10,10,1808,1115,17,2940,0.00101205598786669
"2866","Valley",8,8,1692,562,15,2269,0.000781073141656298
"2867","Washington",16,16,7009,2728,47,9784,0.00336801217186656
"2868","Wayne",12,12,2971,1059,24,4054,0.00139553570571822
"2869","Webster",5,5,1401,557,15,1973,0.000679179069408495
"2870","Wheeler",2,2,366,81,5,452,0.000155595002216239
"2871","York",15,15,5381,1302,48,6731,0.00231705743344581
"2872","Acworth",1,1,221,297,3,521,0.000179347336625355
"2873","Albany",1,1,172,220,4,396,0.000136317745304493
"2874","Alexandria",1,1,459,376,12,847,0.000291568510790165
"2875","Allenstown",1,1,1089,1087,18,2194,0.00075525538686378
"2876","Alstead",1,1,430,642,5,1077,0.000370742958820552
"2877","Alton",1,1,1896,1139,19,3054,0.00105129897515131
"2878","Amherst",1,1,3637,3469,36,7142,0.0024585387297088
"2879","Andover",1,1,642,721,7,1370,0.000471604320876654
"2880","Antrim",1,1,689,715,11,1415,0.000487094973752164
"2881","Ashland",1,1,600,461,9,1070,0.000368333301706584
"2882","Atkinson",1,1,2457,1836,23,4316,0.00148572572912674
"2883","Auburn",1,1,1832,1105,16,2953,0.00101653106536406
"2884","Barnstead",1,1,1274,1050,11,2335,0.000803792765873713
"2885","Barrington",1,1,2086,2216,32,4334,0.00149192199027695
"2886","Bartlett",1,1,842,1090,10,1942,0.000668507730760921
"2887","Bath",1,1,262,213,4,479,0.000164889393941545
"2888","Bedford",1,1,6836,4047,37,10920,0.00375906509779056
"2889","Belmont",1,1,1882,1431,32,3345,0.00115147186374628
"2890","Bennington",1,1,371,369,8,748,0.000257489074464042
"2891","Benton",1,1,116,60,1,177,6.09299013103414e-05
"2892","Berlin",4,4,1741,3097,20,4858,0.001672302037094
"2893","Bethlehem",1,1,597,771,11,1379,0.000474702451451756
"2894","Boscawen",1,1,828,840,8,1676,0.000576940760430126
"2895","Bow",1,1,2403,2276,22,4701,0.001618256870395
"2896","Bradford",1,1,445,532,6,983,0.000338384706147263
"2897","Brentwood",1,1,1114,913,18,2045,0.000703964114009312
"2898","Bridgewater",1,1,348,280,4,632,0.000217557613718281
"2899","Bristol",1,1,877,727,14,1618,0.000556975030057245
"2900","Brookfield",1,1,257,187,2,446,0.000153529581832838
"2901","Brookline",1,1,1429,1157,19,2605,0.000896736683126776
"2902","Campton",1,1,763,869,13,1645,0.000566269421782552
"2903","Canaan",1,1,735,917,18,1670,0.000574875340046724
"2904","Candia",1,1,1502,977,16,2495,0.000858870642764417
"2905","Canterbury",1,1,631,896,5,1532,0.000527370671228492
"2906","Carroll",1,1,243,243,3,489,0.000168331761247214
"2907","Center Harbor",1,1,382,324,3,709,0.000244063841971933
"2908","Charlestown",1,1,1007,1295,12,2314,0.000796563794531808
"2909","Chatham",1,1,116,69,7,192,6.60934522688449e-05
"2910","Chester",1,1,1614,940,18,2572,0.000885376871018069
"2911","Chesterfield",1,1,915,1208,11,2134,0.000734601183029766
"2912","Chichester",1,1,741,665,8,1414,0.000486750737021598
"2913","Claremont",3,3,2575,3253,50,5878,0.00202342350227224
"2914","Clarksville",1,1,92,54,1,147,5.06027993933344e-05
"2915","Colebrook",1,1,615,384,21,1020,0.000351121465178239
"2916","Columbia",1,1,235,123,1,359,0.000123580986273517
"2917","Concord",10,10,8202,12662,122,20986,0.00722415202767698
"2918","Conway",1,1,2300,2752,52,5104,0.00175698427281346
"2919","Cornish",1,1,431,608,3,1042,0.000358694673250711
"2920","Croydon",1,1,248,157,2,407,0.000140104349340729
"2921","Dalton",1,1,293,206,4,503,0.000173151075475151
"2922","Danbury",1,1,357,278,7,642,0.00022099998102395
"2923","Danville",1,1,1261,929,21,2211,0.000761107411283417
"2924","Deerfield",1,1,1359,1030,22,2411,0.000829954757396798
"2925","Deering",1,1,487,487,5,979,0.000337007759224996
"2926","Derry",1,1,8038,6760,79,14877,0.00512120984064378
"2927","Dixville",1,1,19,7,0,26,8.95015499473942e-06
"2928","Dorchester",1,1,114,70,1,185,6.36837951548766e-05
"2929","Dover",6,6,6206,9225,95,15526,0.0053446194787817
"2930","Dublin",1,1,464,633,4,1101,0.000379004640354158
"2931","Dummer",1,1,126,62,0,188,6.47165053465773e-05
"2932","Dunbarton",1,1,827,673,8,1508,0.000519108989694886
"2933","Durham",1,1,1772,4272,51,6095,0.00209812287280526
"2934","East Kingston",1,1,686,497,9,1192,0.000410330182835746
"2935","Easton",1,1,69,119,1,189,6.50607420771442e-05
"2936","Eaton",1,1,116,153,3,272,9.3632390714197e-05
"2937","Effingham",1,1,376,338,7,721,0.000248194682738735
"2938","Ellsworth",1,1,34,23,1,58,1.99657303728802e-05
"2939","Enfield",1,1,979,1370,20,2369,0.000815496814712988
"2940","Epping",1,1,1555,1551,25,3131,0.00107780520340497
"2941","Epsom",1,1,1308,1024,12,2344,0.000806890896448815
"2942","Errol",1,1,137,60,3,200,6.88473461133801e-05
"2943","Exeter",1,1,3543,4659,39,8241,0.00283685489660183
"2944","Farmington",1,1,1452,1379,19,2850,0.000981074682115667
"2945","Fitzwilliam",1,1,610,677,17,1304,0.000448884696659238
"2946","Francestown",1,1,532,510,5,1047,0.000360415856903545
"2947","Franconia",1,1,310,435,4,749,0.000257833311194609
"2948","Franklin",3,3,1813,1920,25,3758,0.00129364163347041
"2949","Freedom",1,1,512,419,18,949,0.000326680657307989
"2950","Fremont",1,1,1154,863,16,2033,0.000699833273242509
"2951","Gilford",1,1,2636,1924,26,4586,0.00157866964637981
"2952","Gilmanton",1,1,1059,939,13,2011,0.000692260065170037
"2953","Gilsum",1,1,207,219,7,433,0.000149054504335468
"2954","Goffstown",1,1,5008,3734,55,8797,0.00302825051879702
"2955","Gorham",1,1,653,975,15,1643,0.000565580948321418
"2956","Goshen",1,1,225,192,6,423,0.000145612137029799
"2957","Grafton",1,1,327,294,2,623,0.000214459483143179
"2958","Grantham",1,1,780,993,10,1783,0.000613774090600784
"2959","Greenfield",1,1,404,420,9,833,0.000286749196562228
"2960","Greenland",1,1,985,1087,11,2083,0.000717045109770854
"2961","Greenville",1,1,451,471,15,937,0.000322549816541186
"2962","Groton",1,1,166,127,10,303,0.000104303729361771
"2963","Hampstead",1,1,2856,2046,35,4937,0.00169949673880879
"2964","Hampton",1,1,4645,4729,61,9435,0.00324787355289871
"2965","Hampton Falls",1,1,853,513,10,1376,0.000473669741260055
"2966","Hancock",1,1,481,718,4,1203,0.000414116786871981
"2967","Hanover",1,1,1444,5152,30,6626,0.00228091257673628
"2968","Harrisville",1,1,218,497,5,720,0.000247850446008168
"2969","Harts Location",1,1,16,14,1,31,1.06713386475739e-05
"2970","Haverhill",1,1,1259,802,26,2087,0.000718422056693122
"2971","Hebron",1,1,250,170,1,421,0.000144923663568665
"2972","Henniker",1,1,1047,1392,22,2461,0.000847166593925143
"2973","Hill",1,1,295,249,6,550,0.000189330201811795
"2974","Hillsborough",1,1,1390,1292,25,2707,0.0009318488296446
"2975","Hinsdale",1,1,675,1185,12,1872,0.000644411159621238
"2976","Holderness",1,1,595,688,8,1291,0.000444409619161869
"2977","Hollis",1,1,2425,2398,26,4849,0.0016692039065189
"2978","Hooksett",1,1,3784,2656,23,6463,0.00222480198965388
"2979","Hopkinton",1,1,1527,2245,19,3791,0.00130500144557912
"2980","Hudson",1,1,6172,5390,83,11645,0.00400863672745156
"2981","Jackson",1,1,272,439,12,723,0.000248883156199869
"2982","Jaffrey",1,1,1459,1495,14,2968,0.00102169461632256
"2983","Jefferson",1,1,387,211,6,604,0.000207918985262408
"2984","Keene",5,5,4004,8369,86,12459,0.00428884542613302
"2985","Kensington",1,1,662,573,8,1243,0.000427886256094658
"2986","Kingston",1,1,1806,1430,23,3259,0.00112186750491753
"2987","Laconia",6,6,4318,3544,47,7909,0.00272256830205362
"2988","Lancaster",1,1,942,751,14,1707,0.000587612099077699
"2989","Landaff",1,1,139,98,2,239,8.22725786054893e-05
"2990","Langdon",1,1,153,195,2,350,0.000120482855698415
"2991","Lebanon",3,3,2302,4048,32,6382,0.00219691881447796
"2992","Lee",1,1,903,1481,19,2403,0.000827200863552262
"2993","Lempster",1,1,284,226,5,515,0.000177281916241954
"2994","Lincoln",1,1,435,395,9,839,0.00028881461694563
"2995","Lisbon",1,1,417,298,8,723,0.000248883156199869
"2996","Litchfield",1,1,2386,1747,16,4149,0.00142823819512207
"2997","Littleton",1,1,1659,1337,32,3028,0.00104234882015658
"2998","Londonderry",1,1,6888,5222,67,12177,0.00419177066811315
"2999","Loudon",1,1,1521,1203,16,2740,0.000943208641753308
"3000","Lyman",1,1,178,129,2,309,0.000106369149745172
"3001","Lyme",1,1,373,794,4,1171,0.000403101211493841
"3002","Lyndeborough",1,1,481,488,11,980,0.000337351995955563
"3003","Madbury",1,1,435,590,9,1034,0.000355940779406175
"3004","Madison",1,1,634,720,7,1361,0.000468506190301552
"3005","Manchester",12,12,23120,22877,251,46248,0.015920260315258
"3006","Marlborough",1,1,396,777,8,1181,0.00040654357879951
"3007","Marlow",1,1,184,261,3,448,0.000154218055293971
"3008","Mason",1,1,408,420,7,835,0.000287437670023362
"3009","Meredith",1,1,2053,1519,27,3599,0.00123890799331028
"3010","Merrimack",1,1,7927,6682,101,14710,0.00506372230663911
"3011","Middleton",1,1,399,380,10,789,0.000271602780417285
"3012","Milan",1,1,347,379,7,733,0.000252325523505538
"3013","Milford",1,1,3757,3516,60,7333,0.00252428794524708
"3014","Millsfield",1,1,12,2,1,15,5.16355095850351e-06
"3015","Milton",1,1,1036,1021,16,2073,0.000713602742465185
"3016","Monroe",1,1,332,187,4,523,0.000180035810086489
"3017","Mont Vernon",1,1,692,653,9,1354,0.000466096533187583
"3018","Moultonborough",1,1,1821,1150,19,2990,0.00102926782439503
"3019","Nashua",9,9,17880,21379,271,39530,0.0136076779593096
"3020","Nelson",1,1,147,278,6,431,0.000148366030874334
"3021","New Boston",1,1,1606,1195,16,2817,0.000969714870006959
"3022","New Castle",1,1,403,383,2,788,0.000271258543686718
"3023","New Durham",1,1,729,657,13,1399,0.000481587186063094
"3024","New Hampton",1,1,654,558,16,1228,0.000422722705136154
"3025","New Ipswich",1,1,1581,807,17,2405,0.000827889337013396
"3026","New London",1,1,1478,1442,16,2936,0.00101067904094442
"3027","Newbury",1,1,630,632,7,1269,0.000436836411089397
"3028","Newfields",1,1,489,473,3,965,0.000332188444997059
"3029","Newington",1,1,303,250,4,557,0.000191739858925764
"3030","Newmarket",1,1,1830,2939,44,4813,0.00165681138421849
"3031","Newport",1,1,1458,1425,20,2903,0.000999319228835713
"3032","Newton",1,1,1160,1103,30,2293,0.000789334823189903
"3033","North Hampton",1,1,1537,1367,9,2913,0.00100276159614138
"3034","Northfield",1,1,1170,1101,13,2284,0.000786236692614801
"3035","Northumberland",1,1,501,542,0,1043,0.000359038909981277
"3036","Northwood",1,1,1107,1058,16,2181,0.00075078030936641
"3037","Nottingham",1,1,1272,1085,17,2374,0.000817217998365822
"3038","Orange",1,1,69,85,2,156,5.37009299684365e-05
"3039","Orford",1,1,318,377,10,705,0.000242686895049665
"3040","Ossipee",1,1,1184,880,25,2089,0.000719110530154255
"3041","Pelham",1,1,3725,2755,35,6515,0.00224270229964336
"3042","Pembroke",1,1,1824,1752,25,3601,0.00123959646677141
"3043","Peterborough",1,1,1439,2310,11,3760,0.00129433010693155
"3044","Piermont",1,1,195,233,6,434,0.000149398741066035
"3045","Pittsburg",1,1,369,149,4,522,0.000179691573355922
"3046","Pittsfield",1,1,1043,867,17,1927,0.000663344179802418
"3047","Plainfield",1,1,508,893,5,1406,0.000483996843177062
"3048","Plaistow",1,1,2331,1804,14,4149,0.00142823819512207
"3049","Plymouth",1,1,1209,2300,24,3533,0.00121618836909286
"3050","Portsmouth",5,5,4185,8436,77,12698,0.0043711180047385
"3051","Randolph",1,1,104,165,3,272,9.3632390714197e-05
"3052","Raymond",1,1,2630,2127,34,4791,0.00164923817614602
"3053","Richmond",1,1,267,340,2,609,0.000209640168915243
"3054","Rindge",1,1,1626,1500,26,3152,0.00108503417474687
"3055","Rochester",6,6,6656,6672,84,13412,0.00461690303036327
"3056","Rollinsford",1,1,646,827,7,1480,0.000509470361239013
"3057","Roxbury",1,1,52,102,2,156,5.37009299684365e-05
"3058","Rumney",1,1,550,404,7,961,0.000330811498074792
"3059","Rye",1,1,1796,1900,29,3725,0.0012822818213617
"3060","Salem",1,1,7797,6472,91,14360,0.00494323945094069
"3061","Salisbury",1,1,396,353,6,755,0.00025989873157801
"3062","Sanbornton",1,1,902,818,13,1733,0.000596562254072439
"3063","Sandown",1,1,1655,1158,16,2829,0.000973845710773762
"3064","Sandwich",1,1,420,584,6,1010,0.00034767909787257
"3065","Seabrook",1,1,2223,2023,28,4274,0.00147126778644293
"3066","Sharon",1,1,90,148,0,238,8.19283418749224e-05
"3067","Shelburne",1,1,144,140,3,287,9.87959416727005e-05
"3068","Somersworth",5,5,2355,3101,37,5493,0.00189089236100399
"3069","South Hampton",1,1,268,276,7,551,0.000189674438542362
"3070","Springfield",1,1,411,324,7,742,0.00025542365408064
"3071","Stark",1,1,169,130,1,300,0.00010327101917007
"3072","Stewartstown",1,1,245,182,3,430,0.000148021794143767
"3073","Stoddard",1,1,323,320,5,648,0.000223065401407352
"3074","Strafford",1,1,1121,1121,16,2258,0.000777286537620062
"3075","Stratford",1,1,139,159,3,301,0.000103615255900637
"3076","Stratham",1,1,2068,2093,14,4175,0.00143718835011681
"3077","Sugar Hill",1,1,160,236,0,396,0.000136317745304493
"3078","Sullivan",1,1,187,212,2,401,0.000138038928957327
"3079","Sunapee",1,1,1108,972,13,2093,0.000720487477076523
"3080","Surry",1,1,224,241,5,470,0.000161791263366443
"3081","Sutton",1,1,510,634,10,1154,0.000397249187074203
"3082","Swanzey",1,1,1520,1950,21,3491,0.00120173042640905
"3083","Tamworth",1,1,736,778,9,1523,0.00052427254065339
"3084","Temple",1,1,365,453,10,828,0.000285028012909394
"3085","Thornton",1,1,623,478,9,1110,0.00038210277092926
"3086","Tilton",1,1,896,867,11,1774,0.000610675960025682
"3087","Troy",1,1,466,568,9,1043,0.000359038909981277
"3088","Tuftonboro",1,1,956,647,11,1614,0.000555598083134978
"3089","Unity",1,1,404,335,6,745,0.000256456364272341
"3090","Wakefield",1,1,1462,1053,16,2531,0.000871263165064826
"3091","Walpole",1,1,883,1296,20,2199,0.000756976570516615
"3092","Warner",1,1,742,903,12,1657,0.000570400262549354
"3093","Warren",1,1,307,189,2,498,0.000171429891822317
"3094","Washington",1,1,329,269,7,605,0.000208263221992975
"3095","Waterville",1,1,81,111,1,193,6.64376889994118e-05
"3096","Weare",1,1,2549,1795,34,4378,0.00150706840642189
"3097","Webster",1,1,521,502,5,1028,0.000353875359022774
"3098","Wentworth",1,1,290,186,5,481,0.000165577867402679
"3099","Wentworths Location",1,1,14,11,1,26,8.95015499473942e-06
"3100","Westmoreland",1,1,432,586,5,1023,0.000352154175369939
"3101","Whitefield",1,1,613,528,16,1157,0.000398281897265904
"3102","Wilmot",1,1,278,456,9,743,0.000255767890811207
"3103","Wilton",1,1,1032,1209,14,2255,0.000776253827428361
"3104","Winchester",1,1,774,1073,28,1875,0.000645443869812939
"3105","Windham",1,1,4204,2829,36,7069,0.00243340944837742
"3106","Windsor",1,1,73,63,0,136,4.68161953570985e-05
"3107","Wolfeboro",1,1,2343,1798,27,4168,0.00143477869300284
"3108","Woodstock",1,1,336,370,9,715,0.000246129262355334
"3109","Atlantic",158,158,46197,52181,535,98913,0.0340494877305638
"3110","Bergen",557,557,178304,192827,1891,373022,0.128407873709526
"3111","Burlington",359,357,90112,103971,945,195028,0.0671358010890015
"3112","Camden",331,331,76925,129918,894,207737,0.0715107056977762
"3113","Cape May",131,131,26316,19614,241,46171,0.0158937540870044
"3114","Cumberland",93,93,23186,26410,154,49750,0.0171257773457033
"3115","Essex",567,566,80822,191999,1052,273873,0.0942771461105488
"3116","Gloucester",237,237,59760,66476,734,126970,0.0437077376800794
"3117","Hudson",452,416,55530,113603,831,169964,0.0585078516740727
"3118","Hunterdon",113,113,39449,25727,484,65660,0.0226025837290227
"3119","Mercer",265,264,53469,85682,771,139922,0.0481662918143819
"3120","Middlesex",597,597,119436,156168,1701,277305,0.0954585665698544
"3121","Monmouth",437,437,161693,131808,2005,295506,0.101724019302903
"3122","Morris",395,395,126761,90476,1154,218391,0.075178203825236
"3123","Ocean",346,346,143797,92621,1571,237989,0.0819245552708861
"3124","Passaic",288,288,73568,91939,833,166340,0.0572603377624983
"3125","Salem",45,45,15635,13650,165,29450,0.0101377717151952
"3126","Somerset",277,277,67505,61550,739,129794,0.0446798622072003
"3127","Sussex",107,106,42085,22282,480,64847,0.0223227192670718
"3128","Union",443,443,77621,112542,980,191143,0.0657984413907491
"3129","Warren",87,87,29323,17876,454,47653,0.0164039129217045
"3130","Bernalillo",413,412,119161,128531,1419,249111,0.0857531561882512
"3131","Catron",9,9,1415,550,7,1972,0.000678834832677928
"3132","Chaves",53,53,14748,6716,103,21567,0.00742415356813635
"3133","Cibola",32,31,3428,3969,86,7483,0.00257592345483212
"3134","Colfax",22,22,3080,2825,33,5938,0.00204407770610626
"3135","Curry",40,40,10647,3536,57,14240,0.00490193104327267
"3136","DeBaca",6,6,705,280,2,987,0.000339761653069531
"3137","Dona Ana",106,106,28710,30174,355,59239,0.0203922396820526
"3138","Eddy",44,44,13240,6866,66,20172,0.00694394332899552
"3139","Grant",38,38,5974,7020,81,13075,0.00450089525216223
"3140","Guadalupe",7,7,914,1340,10,2264,0.000779351958003463
"3141","Harding",4,4,380,259,4,643,0.000221344217754517
"3142","Hidalgo",8,8,1054,830,12,1896,0.000652672841154844
"3143","Lea",47,47,14349,3615,45,18009,0.00619935928077931
"3144","Lincoln",21,21,6079,2833,51,8963,0.00308539381607113
"3145","Los Alamos",19,19,5810,5206,81,11097,0.0038199949991009
"3146","Luna",16,16,4164,3340,48,7552,0.00259967578924123
"3147","McKinley",68,68,7132,12725,97,19954,0.00686889972173194
"3148","Mora",13,13,928,1876,9,2813,0.000968337923084692
"3149","Otero",45,45,13935,6355,127,20417,0.00702828132798441
"3150","Quay",15,15,2661,1422,25,4108,0.00141412448916883
"3151","Rio Arriba",43,43,5136,9737,44,14917,0.00513497930986646
"3152","Roosevelt",21,21,4954,2069,35,7058,0.00242962284434118
"3153","San Juan",73,73,29371,14717,236,44324,0.0152579488456473
"3154","San Miguel",32,32,3216,8435,67,11718,0.00403376600878294
"3155","Sandoval",70,70,22482,21215,214,43911,0.0151157790759232
"3156","Santa Fe",89,89,18315,46553,317,65185,0.0224390712820034
"3157","Sierra",11,11,3135,1910,41,5086,0.00175078801166326
"3158","Socorro",26,26,3677,3991,47,7715,0.00265578637632364
"3159","Taos",37,37,3605,10772,103,14480,0.00498454785860872
"3160","Torrance",17,17,4001,2373,40,6414,0.0022079343898561
"3161","Union",11,11,1454,411,11,1876,0.000645788106543506
"3162","Valencia",39,39,14355,11176,126,25657,0.00883208179615497
"3163","Carson City",28,28,13164,9441,147,22752,0.00783207409385812
"3164","Churchill",21,21,7335,2705,66,10106,0.0034788563991091
"3165","Clark",1042,1042,253432,279575,3052,536059,0.184531197550962
"3166","Douglas",39,39,15192,8269,137,23598,0.00812329836791772
"3167","Elko",42,42,11935,3047,85,15067,0.00518661481945149
"3168","Esmeralda",5,5,367,98,4,469,0.000161447026635876
"3169","Eureka",4,4,571,144,8,723,0.000248883156199869
"3170","Humboldt",16,16,3896,1360,35,5291,0.00182135654142947
"3171","Lander",11,11,1602,414,12,2028,0.000698112089589675
"3172","Lincoln",6,6,1579,418,12,2009,0.000691571591708903
"3173","Lyon",31,31,11136,5637,122,16895,0.00581587956292779
"3174","Mineral",12,12,1336,931,26,2293,0.000789334823189903
"3175","Nye",32,32,8498,5623,128,14249,0.00490502917384777
"3176","Pershing",7,7,1341,538,17,1896,0.000652672841154844
"3177","Storey",7,7,1253,871,17,2141,0.000737010840143734
"3178","Washoe",489,489,79698,73219,879,153796,0.0529422322142671
"3179","White Pine",10,10,2604,1082,38,3724,0.00128193758463114
"3180","Albany",343,343,51297,81666,2618,135581,0.046671960166991
"3181","Allegany",40,40,11560,6067,305,17932,0.00617285305252566
"3182","Bronx",975,975,52752,260438,2270,315460,0.108592919024634
"3183","Brooklyn",2030,2030,156612,468403,5216,630231,0.216948658941908
"3184","Broome",197,197,40207,42092,1644,83943,0.0288962638739773
"3185","Cattaraugus",79,79,18665,12410,577,31652,0.0108957809959035
"3186","Cayuga",65,65,15511,16157,702,32370,0.0111429429684506
"3187","Chautauqua",134,134,29993,25459,1051,56503,0.0194504079872216
"3188","Chemung",85,85,20639,16486,896,38021,0.0130882247328841
"3189","Chenango",42,42,10751,8413,395,19559,0.00673292621315801
"3190","Clinton",70,70,14095,16217,655,30967,0.0106599788354652
"3191","Columbia",55,55,11237,14055,554,25846,0.00889714253823212
"3192","Cortland",42,42,10708,9902,403,21013,0.00723344641940228
"3193","Delaware",59,59,11558,7971,490,20019,0.00689127510921878
"3194","Dutchess",254,254,59122,53034,1837,113993,0.0392405776275127
"3195","Erie",985,962,171061,230986,8980,411027,0.141490590654721
"3196","Essex",39,39,8971,7855,371,17197,0.00591983905555899
"3197","Franklin",49,49,7875,8674,324,16873,0.00580830635485532
"3198","Fulton",50,50,11686,8486,390,20562,0.00707819565391661
"3199","Genesee",53,53,15799,9615,410,25824,0.00888956933015964
"3200","Greene",52,52,13641,9079,466,23186,0.00798147283492416
"3201","Hamilton",11,11,2210,1075,53,3338,0.00114906220663231
"3202","Herkimer",58,58,14894,10706,527,26127,0.00899387305952141
"3203","Jefferson",91,91,19368,15305,728,35401,0.0121863244987989
"3204","Lewis",30,30,6144,4273,197,10614,0.00365372865823708
"3205","Livingston",57,57,17632,11244,622,29498,0.0101542950782624
"3206","Madison",51,51,15345,11947,504,27796,0.00956840416283757
"3207","Manhattan",1234,1234,95362,468841,7996,572199,0.19697191299365
"3208","Monroe",829,829,158856,166355,5186,330397,0.113734783069112
"3209","Montgomery",48,48,10645,8833,374,19852,0.00683378757521411
"3210","Nassau",1142,1142,278727,312388,6020,597135,0.205555800107066
"3211","Niagara",181,181,43808,44072,1675,89555,0.0308281204059188
"3212","Oneida",192,192,49256,37601,2038,88895,0.0306009241637446
"3213","Onondaga",458,458,87694,107429,3537,198660,0.0683860688944205
"3214","Ontario",92,92,26308,19585,754,46647,0.0160576107707542
"3215","Orange",318,318,74397,58944,1806,135147,0.0465225614259249
"3216","Orleans",40,40,9893,5570,249,15712,0.00540864751066714
"3217","Oswego",120,120,24724,23202,976,48902,0.0168338645981826
"3218","Otsego",57,57,12547,11474,482,24503,0.00843483260908077
"3219","Putnam",85,85,25147,18067,499,43713,0.0150476202032709
"3220","Queens",1494,1494,155363,393482,5135,553980,0.190700263999452
"3221","Rensselaer",134,134,32540,33195,1453,67188,0.0231285774533289
"3222","Rockland",270,270,60627,59326,1828,121781,0.0419214932851677
"3223","Saint Lawrence",102,101,16609,20814,726,38149,0.0131322870343967
"3224","Saratoga",193,193,52798,45033,1822,99653,0.0343042229111834
"3225","Schenectady",128,128,30113,33248,1161,64522,0.0222108423296376
"3226","Schoharie",29,29,7892,5128,273,13293,0.00457593885942581
"3227","Schuyler",17,17,4805,3309,159,8273,0.00284787047197997
"3228","Seneca",27,27,7407,6420,293,14120,0.00486062263560464
"3229","Staten Island",357,357,84270,62603,1238,148111,0.0509852464009942
"3230","Steuben",84,84,25292,13318,664,39274,0.0135195533562845
"3231","Suffolk",1038,1038,301710,303375,13251,618336,0.212853963031815
"3232","Sullivan",63,63,13930,13643,547,28120,0.00967993686354125
"3233","Tioga",48,48,12869,8938,367,22174,0.00763310526359046
"3234","Tompkins",70,70,12957,24589,936,38482,0.0132469178656755
"3235","Ulster",164,164,36279,45402,1930,83611,0.0287819772794291
"3236","Warren",69,69,15269,11879,556,27704,0.00953673438362542
"3237","Washington",52,52,12947,9803,548,23298,0.00802002734874765
"3238","Wayne",67,67,23250,14620,640,38510,0.0132565564941313
"3239","Westchester",1022,1020,153426,218336,5544,377306,0.129882583863275
"3240","Wyoming",39,38,11086,5757,236,17079,0.0058792191213521
"3241","Yates",20,20,5794,3772,159,9725,0.00334770220476311
"3242","Adams",35,35,7480,4189,0,11669,0.00401689840898516
"3243","Allen",141,141,31629,15822,0,47451,0.01633437710213
"3244","Ashland",65,65,15826,8345,0,24171,0.00832054601453256
"3245","Ashtabula",127,127,20621,23545,0,44166,0.0152035594422177
"3246","Athens",85,85,9912,17369,0,27281,0.00939112224659562
"3247","Auglaize",39,39,16437,5729,0,22166,0.00763035136974592
"3248","Belmont",83,83,15275,17256,0,32531,0.0111983650820718
"3249","Brown",35,35,12480,7058,0,19538,0.00672569724181611
"3250","Butler",289,289,106735,54185,0,160920,0.0553945746828257
"3251","Carroll",26,26,7531,6190,0,13721,0.00472327218010844
"3252","Champaign",29,29,11432,6752,0,18184,0.00625960070862852
"3253","Clark",100,100,34444,32824,0,67268,0.0231561163917743
"3254","Clermont",191,191,61694,25318,0,87012,0.0299527264000872
"3255","Clinton",32,32,12625,5244,0,17869,0.00615116613849995
"3256","Columbiana",103,103,25212,22884,0,48096,0.0165564097933457
"3257","Coshocton",43,43,9121,6763,0,15884,0.00546785622832465
"3258","Crawford",46,46,13667,7626,0,21293,0.00732983270396102
"3259","Cuyahoga",1437,1437,215624,433262,0,648886,0.223370395150634
"3260","Darke",43,43,17869,7663,0,25532,0.00878905220483411
"3261","Defiance",42,42,11018,6683,0,17701,0.00609333436776471
"3262","Delaware",123,123,52237,26491,0,78728,0.027101069324071
"3263","Erie",63,63,18019,20652,0,38671,0.0133119786077526
"3264","Fairfield",118,118,42057,24321,0,66378,0.0228497457015697
"3265","Fayette",38,38,7221,4244,0,11465,0.00394667411594952
"3266","Franklin",825,825,234196,275573,0,509769,0.175481213904358
"3267","Fulton",35,35,13443,8098,0,21541,0.00741520341314161
"3268","Gallia",35,35,8320,5188,0,13508,0.00464994975649769
"3269","Geauga",96,96,29957,19571,0,49528,0.0170493567915175
"3270","Greene",142,142,46841,29349,0,76190,0.0262273965018922
"3271","Guernsey",37,37,9095,7072,0,16167,0.00556527522307508
"3272","Hamilton",1018,1018,215639,190956,0,406595,0.139964933464849
"3273","Hancock",62,62,24345,9930,0,34275,0.0117987139401805
"3274","Hardin",39,39,8187,4723,0,12910,0.00444409619161869
"3275","Harrison",24,24,4318,3824,0,8142,0.00280277546027571
"3276","Henry",33,33,9770,5027,0,14797,0.00509367090219843
"3277","Highland",37,37,11871,6012,0,17883,0.00615598545272788
"3278","Hocking",32,32,6821,6065,0,12886,0.00443583451008508
"3279","Holmes",19,19,8299,2622,0,10921,0.00375940933452112
"3280","Huron",59,59,14553,10354,0,24907,0.00857390424822979
"3281","Jackson",38,38,8382,5519,0,13901,0.00478523479161049
"3282","Jefferson",91,91,16887,18674,0,35561,0.0122414023756896
"3283","Knox",56,56,16677,9613,0,26290,0.00904998364660382
"3284","Lake",217,217,60615,57471,0,118086,0.040649538565723
"3285","Lawrence",84,84,15178,11874,0,27052,0.0093122920352958
"3286","Licking",125,125,48092,29350,0,77442,0.0266583808885619
"3287","Logan",52,52,14084,6644,0,20728,0.00713533895119072
"3288","Lorain",242,242,59751,76512,0,136263,0.0469067296172376
"3289","Lucas",495,495,85405,128874,0,214279,0.0737627023891449
"3290","Madison",44,44,10931,6080,0,17011,0.00585581102367355
"3291","Mahoning",312,312,47968,81500,0,129468,0.0445676410330355
"3292","Marion",84,84,16729,11492,0,28221,0.0097147047733285
"3293","Medina",149,149,47499,35725,0,83224,0.0286487576646997
"3294","Meigs",27,27,6156,4334,0,10490,0.00361104330364679
"3295","Mercer",39,39,15022,4924,0,19946,0.0068661458278874
"3296","Miami",82,82,33039,17039,0,50078,0.0172386869933293
"3297","Monroe",29,29,3370,4164,0,7534,0.00259347952809103
"3298","Montgomery",589,589,134716,138262,0,272978,0.0939690542366914
"3299","Morgan",22,22,3695,2810,0,6505,0.00223925993233769
"3300","Morrow",36,36,10313,5651,0,15964,0.00549539516677
"3301","Muskingum",85,85,21901,16050,0,37951,0.0130641281617444
"3302","Noble",27,27,3799,2618,0,6417,0.0022089671000478
"3303","Ottawa",78,78,11820,10915,0,22735,0.00782622206943849
"3304","Paulding",30,30,6074,3544,0,9618,0.00331086887459245
"3305","Perry",46,46,7767,7205,0,14972,0.00515391233004764
"3306","Pickaway",53,53,13864,8388,0,22252,0.00765995572857467
"3307","Pike",24,24,6385,5865,0,12250,0.00421689994944453
"3308","Portage",129,129,35054,39915,0,74969,0.02580708345387
"3309","Preble",45,45,13512,7165,0,20677,0.0071177828779318
"3310","Putnam",35,35,14196,4348,0,18544,0.00638352593163261
"3311","Richland",126,126,36253,24056,0,60309,0.0207605729837592
"3312","Ross",76,76,16940,13701,0,30641,0.0105477576613004
"3313","Sandusky",72,72,17824,13909,0,31733,0.0109236641710795
"3314","Scioto",107,107,17938,16438,0,34376,0.0118334818499678
"3315","Seneca",54,54,15624,10770,0,26394,0.00908578426658278
"3316","Shelby",35,35,15825,6337,0,22162,0.00762897442282365
"3317","Stark",364,364,89859,92295,0,182154,0.0627040974196832
"3318","Summit",498,498,116184,152897,0,269081,0.0926275636976722
"3319","Trumbull",274,274,40220,65321,0,105541,0.0363310887807613
"3320","Tuscarawas",81,81,23359,18460,0,41819,0.0143956358355772
"3321","Union",46,46,15593,6546,0,22139,0.00762105697802061
"3322","Van Wert",39,39,10484,4026,0,14510,0.00499487496052573
"3323","Vinton",20,20,3194,2612,0,5806,0.00199863845767143
"3324","Warren",165,165,66523,25399,0,91922,0.0316429287471706
"3325","Washington",56,56,17029,12137,0,29166,0.0100400084837142
"3326","Wayne",97,97,31433,19455,0,50888,0.0175175187450884
"3327","Williams",44,44,11633,6231,0,17864,0.00614944495484711
"3328","Wood",105,105,32574,28216,0,60790,0.0209261508511619
"3329","Wyandot",27,27,6956,3554,0,10510,0.00361792803825813
"3330","Adair",18,18,4971,2560,0,7531,0.00259244681789933
"3331","Alfalfa",11,11,2201,470,0,2671,0.000919456307344192
"3332","Atoka",15,15,3140,1946,0,5086,0.00175078801166326
"3333","Beaver",9,9,2271,297,0,2568,0.000883999924095801
"3334","Beckham",13,13,5454,1931,0,7385,0.00254218825523656
"3335","Blaine",11,11,3199,1222,0,4421,0.00152187058583627
"3336","Bryan",29,29,8614,5742,0,14356,0.00494186250401843
"3337","Caddo",25,25,6491,3916,0,10407,0.00358247165500974
"3338","Canadian",54,54,33297,9712,0,43009,0.0148052775449518
"3339","Carter",28,28,12173,6464,0,18637,0.00641553994757533
"3340","Cherokee",26,26,9563,8622,0,18185,0.00625994494535909
"3341","Choctaw",18,18,3168,2639,0,5807,0.00199898269440199
"3342","Cimarron",7,7,1242,184,0,1426,0.0004908815777884
"3343","Cleveland",92,92,65704,33998,0,99702,0.0343210905109811
"3344","Coal",12,12,1396,1203,0,2599,0.000894671262743375
"3345","Comanche",43,43,21163,12020,0,33183,0.0114228074304015
"3346","Cotton",12,12,1742,898,0,2640,0.000908784968696618
"3347","Craig",17,17,3894,2504,0,6398,0.00220242660216703
"3348","Creek",43,43,18845,9927,0,28772,0.00990437921187087
"3349","Custer",13,13,7839,2801,0,10640,0.00366267881323182
"3350","Delaware",22,22,10016,5591,0,15607,0.00537250265395762
"3351","Dewey",11,11,1843,408,0,2251,0.000774876880506093
"3352","Ellis",10,10,1685,395,0,2080,0.000716012399579153
"3353","Garfield",34,34,17685,5586,0,23271,0.00801073295702234
"3354","Garvin",24,24,7610,3706,0,11316,0.00389538284309505
"3355","Grady",42,42,14129,5969,0,20098,0.00691846981093357
"3356","Grant",10,10,1950,571,0,2521,0.000867820797759157
"3357","Greer",16,16,1529,719,0,2248,0.000773844170314393
"3358","Harmon",8,8,838,354,0,1192,0.000410330182835746
"3359","Harper",9,9,1397,268,0,1665,0.00057315415639389
"3360","Haskell",17,17,2946,2378,0,5324,0.00183271635353818
"3361","Hughes",16,16,3066,2283,0,5349,0.00184132227180235
"3362","Jackson",19,19,7024,2232,0,9256,0.00318625517812723
"3363","Jefferson",11,11,1546,1057,0,2603,0.000896048209665642
"3364","Johnston",13,13,2634,1711,0,4345,0.00149570859431318
"3365","Kay",34,34,14121,5956,0,20077,0.00691124083959166
"3366","Kingfisher",17,17,5629,1022,0,6651,0.00228951849500046
"3367","Kiowa",14,14,2608,1413,0,4021,0.00138417589360951
"3368","Latimer",13,13,2535,1945,0,4480,0.00154218055293972
"3369","LeFlore",39,39,10681,6740,0,17421,0.00599694808320598
"3370","Lincoln",23,23,10149,4041,0,14190,0.00488471920674432
"3371","Logan",23,23,11467,4869,0,16336,0.00562345123054089
"3372","Love",13,13,2295,1538,0,3833,0.00131945938826293
"3373","Major",14,14,3122,537,0,3659,0.00125956219714429
"3374","Marshall",12,12,3363,2088,0,5451,0.00187643441832018
"3375","Mayes",26,26,9946,6933,0,16879,0.00581037177523872
"3376","McClain",26,26,10038,3742,0,13780,0.00474358214721189
"3377","McCurtain",32,32,7472,3684,0,11156,0.00384030496620434
"3378","McIntosh",17,17,4692,4488,0,9180,0.00316009318660415
"3379","Murray",13,13,3665,2310,0,5975,0.00205681446513723
"3380","Muskogee",34,34,15121,12585,0,27706,0.00953742285708655
"3381","Noble",17,17,3993,1335,0,5328,0.00183409330046045
"3382","Nowata",12,12,2805,1659,0,4464,0.00153667276525064
"3383","Okfuskee",16,16,2542,1743,0,4285,0.00147505439047917
"3384","Oklahoma",303,303,174707,97283,0,271990,0.0936289483468913
"3385","Okmulgee",39,39,8363,7367,0,15730,0.00541484377181735
"3386","Osage",31,31,11467,8068,0,19535,0.0067246645316244
"3387","Ottawa",22,22,7441,5084,0,12525,0.00431156505035043
"3388","Pawnee",12,12,4412,2563,0,6975,0.00240105119570413
"3389","Payne",40,40,19560,10101,0,29661,0.0102104056653448
"3390","Pittsburg",50,50,11134,7452,0,18586,0.00639798387431642
"3391","Pontotoc",26,26,9647,5165,0,14812,0.00509883445315693
"3392","Pottawatomie",31,31,17212,8636,0,25848,0.00889783101169325
"3393","Pushmataha",17,17,2862,1934,0,4796,0.00165095935979886
"3394","Roger Mills",10,10,1388,382,0,1770,0.000609299013103414
"3395","Rogers",34,34,24974,11917,0,36891,0.0126992372273435
"3396","Seminole",16,16,5623,3648,0,9271,0.00319141872908574
"3397","Sequoyah",33,33,8865,5910,0,14775,0.00508609769412596
"3398","Stephens",29,29,13645,5514,0,19159,0.00659523152093125
"3399","Texas",16,16,5449,1016,0,6465,0.00222549046311501
"3400","Tillman",10,10,2273,1175,0,3448,0.00118692824699467
"3401","Tulsa",268,268,163434,90204,0,253638,0.0873115158675276
"3402","Wagoner",43,43,19081,9157,0,28238,0.00972055679774814
"3403","Washington",24,24,16551,6862,0,23413,0.00805961457276285
"3404","Washita",13,13,3705,1340,0,5045,0.00173667430571001
"3405","Woods",8,8,3165,930,0,4095,0.00140964941167146
"3406","Woodward",16,16,6188,1457,0,7645,0.00263168980518396
"3407","Baker",5,5,6155,2585,0,8740,0.00300862902515471
"3408","Benton",24,24,18057,25877,0,43934,0.0151236965207262
"3409","Clackamas",105,105,91399,88388,0,179787,0.0618892890784314
"3410","Clatsop",11,11,8168,10116,0,18284,0.00629402438168521
"3411","Columbia",13,13,11821,12488,0,24309,0.00836805068335079
"3412","Coos",19,19,16164,12849,0,29013,0.00998734026393749
"3413","Crook",6,6,6815,3016,0,9831,0.0033841912982032
"3414","Curry",7,7,7302,5195,0,12497,0.00430192642189456
"3415","Deschutes",41,41,41203,30721,0,71924,0.0247588826092938
"3416","Douglas",31,31,35508,17924,0,53432,0.0183932569876506
"3417","Gilliam",1,1,754,369,0,1123,0.000386577848426629
"3418","Grant",2,2,2809,683,0,3492,0.00120207466313962
"3419","Harney",2,2,2804,832,0,3636,0.00125164475234125
"3420","Hood River",5,5,4089,5525,0,9614,0.00330949192767018
"3421","Jackson",57,57,53035,41586,0,94621,0.0325720236829707
"3422","Jefferson",5,5,4723,3202,0,7925,0.00272807608974269
"3423","Josephine",26,26,25869,14959,0,40828,0.0140544972355854
"3424","Klamath",18,18,22412,8158,0,30570,0.0105233168534302
"3425","Lake",2,2,3033,800,0,3833,0.00131945938826293
"3426","Lane",97,97,69289,99048,0,168337,0.0579477785134404
"3427","Lincoln",13,13,9964,13460,0,23424,0.00806340117679908
"3428","Linn",28,28,30461,19376,0,49837,0.0171557259412626
"3429","Malheur",6,6,8077,2552,0,10629,0.00365889220919559
"3430","Marion",69,69,62682,51432,0,114114,0.0392822302719113
"3431","Morrow",2,2,2719,1355,0,4074,0.00140242044032955
"3432","Multnomah",199,199,93219,245733,0,338952,0.116679728299112
"3433","Polk",20,20,19140,15175,0,34315,0.0118124834094032
"3434","Sherman",1,1,690,389,0,1079,0.000371431432281686
"3435","Tillamook",8,8,6834,6576,0,13410,0.00461621455690214
"3436","Umatilla",16,16,16789,8738,0,25527,0.00878733102118127
"3437","Union",8,8,8730,4346,0,13076,0.00450123948889279
"3438","Wallowa",2,2,3122,1265,0,4387,0.00151016653699699
"3439","Wasco",7,7,5988,5557,0,11545,0.00397421305439487
"3440","Washington",124,124,101324,113921,0,215245,0.0740952350708725
"3441","Wheeler",1,1,610,244,0,854,0.000293978167904133
"3442","Yamhill",23,23,21452,16258,0,37710,0.0129811671096778
"3443","Adams",51,51,27883,13600,0,41483,0.0142799722941067
"3444","Allegheny",1307,1307,268387,363674,0,632061,0.217578612158846
"3445","Armstrong",74,74,18871,11999,0,30870,0.0106265878726002
"3446","Beaver",130,130,39705,41874,0,81579,0.0280824882429172
"3447","Bedford",41,41,16586,6007,0,22593,0.00777734045369799
"3448","Berks",180,180,82486,72499,0,154985,0.0533515296869111
"3449","Blair",97,97,35422,17972,0,53394,0.0183801759918891
"3450","Bradford",61,61,16753,8420,0,25173,0.00866547121856059
"3451","Bucks",298,298,153424,162220,0,315644,0.108656258583059
"3452","Butler",82,82,54654,29913,0,84567,0.0291110675938511
"3453","Cambria",165,165,33837,32397,0,66234,0.0228001756123681
"3454","Cameron",10,10,1599,794,0,2393,0.000823758496246593
"3455","Carbon",47,47,12458,12169,0,24627,0.00847751796367106
"3456","Centre",85,85,32789,30396,0,63185,0.0217505978208696
"3457","Chester",220,220,119106,108670,0,227776,0.0784088655416064
"3458","Clarion",41,41,10546,5830,0,16376,0.00563722069976356
"3459","Clearfield",71,71,20458,13471,0,33929,0.0116796080314044
"3460","Clinton",37,37,7991,5802,0,13793,0.00474805722470926
"3461","Columbia",57,57,15914,10598,0,26512,0.00912640420078967
"3462","Crawford",67,67,21785,15856,0,37641,0.0129574147752687
"3463","Cumberland",96,96,67175,37577,0,104752,0.036059486000344
"3464","Dauphin",159,159,64816,54653,0,119469,0.0411256179640971
"3465","Delaware",410,410,116728,157531,0,274259,0.0944100214885476
"3466","Elk",33,33,7813,6578,0,14391,0.00495391078958827
"3467","Erie",153,153,56895,67067,0,123962,0.0426722735945341
"3468","Fayette",105,105,24484,28289,0,52773,0.018166404982207
"3469","Forest",9,9,1511,953,0,2464,0.000848199304116843
"3470","Franklin",75,75,40764,16127,0,56891,0.0195839718386815
"3471","Fulton",13,13,4731,1461,0,6192,0.00213151383567025
"3472","Greene",44,44,7766,7649,0,15415,0.00530640920168877
"3473","Huntingdon",58,58,12124,5878,0,18002,0.00619694962366535
"3474","Indiana",68,68,20116,15734,0,35850,0.0123408867908234
"3475","Jefferson",52,52,13242,6021,0,19263,0.00663103214091021
"3476","Juniata",20,20,7063,2759,0,9822,0.0033810931676281
"3477","Lackawanna",239,239,44562,59305,0,103867,0.0357548364937923
"3478","Lancaster",225,225,144291,73395,0,217686,0.0749355169301863
"3479","Lawrence",106,106,21542,21131,0,42673,0.0146896140034814
"3480","Lebanon",55,55,36796,17917,0,54713,0.0188342242395068
"3481","Lehigh",145,145,70474,73747,0,144221,0.049646165519089
"3482","Luzerne",316,316,64751,68665,0,133416,0.0459266876453136
"3483","Lycoming",86,86,33476,15784,0,49260,0.0169571013477255
"3484","McKean",42,42,10780,6193,0,16973,0.00584273002791201
"3485","Mercer",100,100,24545,22761,0,47306,0.0162844627761978
"3486","Mifflin",30,30,11628,4878,0,16506,0.00568197147473726
"3487","Monroe",50,50,27708,27674,0,55382,0.0190645186122561
"3488","Montgomery",407,407,172206,217342,0,389548,0.134096729918875
"3489","Montour",15,15,4867,2634,0,7501,0.00258211971598232
"3490","Northampton",149,149,61636,62974,0,124610,0.0428953389959415
"3491","Northumberland",94,94,22124,14517,0,36641,0.0126131780447018
"3492","Perry",33,33,13885,5408,0,19293,0.00664135924282721
"3493","Philadelphia",1681,1667,125184,522812,0,647996,0.223064024460429
"3494","Pike",16,16,12328,8577,0,20905,0.00719626885250106
"3495","Potter",33,33,5602,2244,0,7846,0.0027008813880279
"3496","Schuylkill",167,167,35449,29091,0,64540,0.0222170385907878
"3497","Snyder",25,25,10521,4319,0,14840,0.00510847308161281
"3498","Somerset",68,68,23686,12802,0,36488,0.0125605098249251
"3499","Sullivan",15,15,2018,1201,0,3219,0.00110809803569485
"3500","Susquehanna",43,43,11420,7237,0,18657,0.00642242468218667
"3501","Tioga",44,44,11849,5341,0,17190,0.00591742939844502
"3502","Union",27,27,10288,5665,0,15953,0.00549160856273377
"3503","Venango",49,49,14213,8886,0,23099,0.00795152423936484
"3504","Warren",33,33,10971,8035,0,19006,0.00654256330115451
"3505","Washington",184,184,46944,47357,0,94301,0.0324618679291893
"3506","Wayne",37,37,13596,7995,0,21591,0.00743241524966995
"3507","Westmoreland",306,306,98792,76966,0,175758,0.0605023592909773
"3508","Wyoming",30,30,7726,4914,0,12640,0.00435115227436562
"3509","York",159,159,114621,63628,0,178249,0.0613598529868195
"3510","Barrington",9,9,3859,5006,71,8936,0.00307609942434582
"3511","Bristol",12,12,3822,6013,96,9931,0.00341861497125989
"3512","Burrillville",7,7,2913,3062,58,6033,0.00207678019551011
"3513","Central Falls",9,9,718,2503,14,3235,0.00111360582338392
"3514","Charlestown",8,8,1742,2181,38,3961,0.00136352168977549
"3515","Coventry",20,20,7043,8105,164,15312,0.00527095281844038
"3516","Cranston",51,51,13898,19454,279,33631,0.0115770254856954
"3517","Cumberland",19,19,6771,8367,130,15268,0.00525580640229544
"3518","East Greenwich",9,9,3449,3051,73,6573,0.00226266803001624
"3519","East Providence",27,27,6161,13040,154,19355,0.00666270192012236
"3520","Exeter",4,4,1382,1458,42,2882,0.000992090257493808
"3521","Foster",3,3,1080,1171,37,2288,0.000787613639537069
"3522","Glocester",6,6,2737,2800,67,5604,0.00192910263809691
"3523","Hopkinton",4,4,1546,1773,66,3385,0.00116524133296896
"3524","Jamestown",4,4,1276,1975,55,3306,0.00113804663125417
"3525","Johnston",19,19,5637,7484,86,13207,0.00454633450059706
"3526","Lincoln",17,17,4824,5589,88,10501,0.00361482990768302
"3527","Little Compton",3,3,969,1100,34,2103,0.000723929844382192
"3528","Middletown",9,9,2976,3788,66,6830,0.00235113686977193
"3529","Narragansett",12,12,3225,4643,73,7941,0.00273358387743176
"3530","New Shoreham",2,2,279,589,21,889,0.000306026453473975
"3531","Newport",15,15,3419,6048,100,9567,0.00329331280133354
"3532","North Kingstown",15,15,6132,6994,134,13260,0.0045645790473171
"3533","North Providence",19,19,5519,9405,90,15014,0.00516837027273145
"3534","North Smithfield",7,7,2595,2827,53,5475,0.00188469609985378
"3535","Pawtucket",35,35,6136,14996,168,21300,0.00733224236107498
"3536","Portsmouth",13,13,4040,4508,78,8626,0.00296938603787009
"3537","Providence",102,102,9346,34299,502,44147,0.015197018944337
"3538","Richmond",5,5,1556,1794,53,3403,0.00117143759411916
"3539","Scituate",6,6,2843,2411,74,5328,0.00183409330046045
"3540","Smithfield",11,11,4221,4576,96,8893,0.00306129724493145
"3541","South Kingstown",13,13,4726,7580,140,12446,0.00428437034863565
"3542","Tiverton",9,9,2857,4104,63,7024,0.00241791879550191
"3543","Warren",6,6,1752,2742,49,4543,0.00156386746696543
"3544","Warwick",54,54,15400,21472,350,37222,0.0128131795851612
"3545","West Greenwich",4,4,1419,1271,44,2734,0.000941143221369906
"3546","West Warwick",16,16,4497,6353,91,10941,0.00376629406913246
"3547","Westerly",15,15,4499,5683,103,10285,0.00354047477388057
"3548","Woonsocket",17,17,4390,7192,90,11672,0.00401793111917686
"3549","Abbeville",14,14,5435,4389,28,9852,0.00339142026954511
"3550","Aiken",80,80,38912,19687,197,58796,0.0202397428104115
"3551","Allendale",8,8,984,2563,6,3553,0.0012230731037042
"3552","Anderson",76,76,43313,20670,224,64207,0.022102407759509
"3553","Bamberg",13,13,2135,3837,5,5977,0.00205750293859837
"3554","Barnwell",15,15,4602,3979,18,8599,0.00296009164614478
"3555","Beaufort",76,76,33234,21462,217,54913,0.0189030715856202
"3556","Berkeley",52,52,32042,20102,150,52294,0.0180015155882655
"3557","Calhoun",14,14,3447,3390,25,6862,0.00236215244515007
"3558","Charleston",186,186,62179,57249,538,119966,0.0412967036191888
"3559","Cherokee",33,33,12064,6443,62,18569,0.00639213184989678
"3560","Chester",22,22,5205,5200,42,10447,0.00359624112423241
"3561","Chesterfield",29,29,7176,6642,29,13847,0.00476664600815987
"3562","Clarendon",25,25,6035,7050,21,13106,0.0045115665908098
"3563","Colleton",32,32,7242,6672,57,13971,0.00480933136275017
"3564","Darlington",33,33,13406,11811,52,25269,0.00869851794469501
"3565","Dillon",20,20,4293,4831,22,9146,0.00314838913776487
"3566","Dorchester",53,53,26006,14733,148,40887,0.0140748072026889
"3567","Edgefield",11,11,5611,4051,22,9684,0.00333358849880987
"3568","Fairfield",22,22,3515,5748,15,9278,0.0031938283861997
"3569","Florence",71,71,27488,21267,136,48891,0.0168300779941463
"3570","Georgetown",43,43,12420,10456,161,23037,0.00793018156206969
"3571","Greenville",137,137,109292,54286,637,164215,0.0565288347100436
"3572","Greenwood",33,33,14136,8859,75,23070,0.0079415413741784
"3573","Hampton",18,18,3093,4814,11,7918,0.00272566643262872
"3574","Horry",108,108,50382,29489,309,80180,0.0276009010568541
"3575","Jasper",14,14,2929,3828,28,6785,0.00233564621689642
"3576","Kershaw",30,30,14160,8515,76,22751,0.00783172985712756
"3577","Lancaster",27,27,12916,7631,104,20651,0.00710883272293707
"3578","Laurens",37,37,14367,9109,63,23539,0.00810298840081427
"3579","Lee",26,26,2891,4900,10,7801,0.00268539073515239
"3580","Lexington",75,75,67030,25341,293,92664,0.0318983524012513
"3581","Marion",17,17,5037,6876,22,11935,0.00410846537931596
"3582","Marlboro",15,15,3423,4984,30,8437,0.00290432529579294
"3583","McCormick",10,10,2445,2643,9,5097,0.00175457461569949
"3584","Newberry",31,31,7313,4286,75,11674,0.004018619592638
"3585","Oconee",30,30,18715,8326,125,27166,0.00935153502258042
"3586","Orangeburg",62,62,12676,24655,65,37396,0.0128730767762798
"3587","Pickens",52,52,29706,10272,139,40117,0.0138097449201524
"3588","Richland",124,124,55922,75863,467,132252,0.0455259960909337
"3589","Saluda",19,19,4499,2989,25,7513,0.00258625055674912
"3590","Spartanburg",92,92,61892,33545,300,95737,0.0329561918742834
"3591","Sumter",62,62,18037,18631,75,36743,0.0126482901912196
"3592","Union",23,23,6592,5036,35,11663,0.00401483298860176
"3593","Williamsburg",33,33,4793,9039,25,13857,0.00477008837546554
"3594","York",60,60,45180,24201,258,69639,0.0239723016799484
"3595","Aurora",7,7,1009,620,15,1644,0.000565925185051985
"3596","Beadle",21,21,4917,3443,77,8437,0.00290432529579294
"3597","Bennett",8,8,833,759,16,1608,0.000553532662751576
"3598","Bon Homme",5,5,2063,1293,36,3392,0.00116765099008293
"3599","Brookings",15,15,7662,5443,190,13295,0.00457662733288694
"3600","Brown",22,22,10386,7943,197,18526,0.0063773296704824
"3601","Brule",5,5,1544,1040,30,2614,0.000899834813701878
"3602","Buffalo",3,3,223,603,10,836,0.000287781906753929
"3603","Butte",16,16,3162,1009,45,4216,0.00145130205607005
"3604","Campbell",5,5,708,239,4,951,0.000327369130769123
"3605","Charles Mix",13,13,2555,2155,73,4783,0.00164648428230149
"3606","Clark",13,13,1435,875,11,2321,0.000798973451645776
"3607","Clay",12,12,2692,3313,95,6100,0.00209984405645809
"3608","Codington",33,33,7778,4803,135,12716,0.00437731426588871
"3609","Corson",17,17,720,971,14,1705,0.000586923625616566
"3610","Custer",10,10,2922,1272,58,4252,0.00146369457837046
"3611","Davison",21,21,5561,3262,94,8917,0.00306955892646505
"3612","Day",14,14,1670,1817,32,3519,0.00121136905486492
"3613","Deuel",11,11,1406,961,25,2392,0.000823414259516026
"3614","Dewey",13,13,921,1606,26,2553,0.000878836373137297
"3615","Douglas",5,5,1596,393,14,2003,0.000689506171325502
"3616","Edmunds",7,7,1434,765,19,2218,0.000763517068397386
"3617","Fall River",17,17,2409,1323,67,3799,0.00130775533942366
"3618","Faulk",11,11,945,418,5,1368,0.00047091584741552
"3619","Grant",19,19,2392,1633,43,4068,0.00140035501994615
"3620","Gregory",3,3,1685,813,36,2534,0.000872295875256526
"3621","Haakon",6,6,1007,219,7,1233,0.000424443888788989
"3622","Hamlin",7,7,1946,1015,37,2998,0.00103202171823957
"3623","Hand",12,12,1482,668,29,2179,0.000750091835905277
"3624","Hanson",8,8,1379,745,23,2147,0.000739076260527136
"3625","Harding",10,10,704,94,13,811,0.000279175988489756
"3626","Hughes",18,18,6017,2697,76,8790,0.00302584086168306
"3627","Hutchinson",10,10,2898,1178,49,4125,0.00141997651358847
"3628","Hyde",5,5,631,259,6,896,0.000308436110587943
"3629","Jackson",8,8,726,508,21,1255,0.00043201709686146
"3630","Jerauld",5,5,736,482,13,1231,0.000423755415327855
"3631","Jones",5,5,565,134,11,710,0.000244408078702499
"3632","Kingsbury",6,6,1804,1163,34,3001,0.00103305442843127
"3633","Lake",18,18,3359,2508,108,5975,0.00205681446513723
"3634","Lawrence",11,11,7489,3857,176,11522,0.00396629560959183
"3635","Lincoln",22,22,11158,5703,140,17001,0.00585236865636788
"3636","Lyman",7,7,1029,871,21,1921,0.000661278759419016
"3637","Marshall",9,9,1241,1099,14,2354,0.000810333263754484
"3638","McCook",6,6,2017,1201,38,3256,0.00112083479472583
"3639","McPherson",6,6,1180,369,18,1567,0.000539418956798333
"3640","Meade",37,37,8341,2939,117,11397,0.00392326601827097
"3641","Mellette",4,4,553,361,10,924,0.000318074739043816
"3642","Miner",8,8,810,641,13,1464,0.000503962573549943
"3643","Minnehaha",69,69,44180,32303,803,77286,0.0266046799585935
"3644","Moody",6,6,1790,1609,36,3435,0.0011824531694973
"3645","Pennington",46,46,29972,14213,540,44725,0.0153959877746046
"3646","Perkins",10,10,1329,418,25,1772,0.000609987486564548
"3647","Potter",8,8,1143,463,9,1615,0.000555942319865545
"3648","Roberts",14,14,2394,2525,49,4968,0.00171016807745636
"3649","Sanborn",7,7,817,581,19,1417,0.000487783447213298
"3650","Shannon",10,10,526,3563,70,4159,0.00143168056242774
"3651","Spink",9,9,2259,1478,27,3764,0.00129570705385381
"3652","Stanley",8,8,1129,464,20,1613,0.000555253846404411
"3653","Sully",6,6,702,201,14,917,0.000315665081929848
"3654","Todd",9,9,889,2543,46,3478,0.00119725534891168
"3655","Tripp",13,13,2230,972,29,3231,0.00111222887646166
"3656","Turner",8,8,3084,1646,81,4811,0.00165612291075736
"3657","Union",13,13,3987,3000,43,7030,0.00241998421588531
"3658","Walworth",15,15,1967,887,20,2874,0.000989336363649273
"3659","Yankton",14,14,6000,4236,129,10365,0.00356801371232593
"3660","Ziebach",8,8,447,640,16,1103,0.000379693113815291
"3661","Anderson",30,30,18510,12896,147,31553,0.0108617015595774
"3662","Bedford",19,19,8348,5261,54,13663,0.00470330644973556
"3663","Benton",7,7,3161,3869,34,7064,0.00243168826472459
"3664","Bledsoe",16,16,2849,1927,13,4789,0.00164854970268489
"3665","Blount",53,53,33240,15042,204,48486,0.0166906621182667
"3666","Bradley",18,18,25942,9426,132,35500,0.012220403935125
"3667","Campbell",22,22,7859,6163,54,14076,0.00484547621945969
"3668","Cannon",10,10,2923,2510,21,5454,0.00187746712851188
"3669","Carroll",23,23,6603,5070,56,11729,0.00403755261281918
"3670","Carter",22,22,15763,6390,25,22178,0.00763448221051272
"3671","Cheatham",9,9,9676,5918,56,15650,0.005387304833372
"3672","Chester",16,16,4086,2182,18,6286,0.00216387208834354
"3673","Claiborne",21,21,6447,4033,31,10511,0.00361827227498869
"3674","Clay",7,7,1647,1673,15,3335,0.00114802949644061
"3675","Cocke",20,20,8290,3932,50,12272,0.004224473157517
"3676","Coffee",25,25,11785,8238,70,20093,0.00691674862728074
"3677","Crockett",12,12,3239,2455,12,5706,0.00196421478461474
"3678","Cumberland",29,29,15142,8326,86,23554,0.00810815195177278
"3679","Davidson",174,174,107618,132362,988,240968,0.0829500364912449
"3680","Decatur",13,13,2566,2268,25,4859,0.00167264627382457
"3681","DeKalb",17,17,3685,3445,32,7162,0.00246542346432014
"3682","Dickson",19,19,10557,8592,78,19227,0.0066186396186098
"3683","Dyer",16,16,8447,5287,55,13789,0.00474668027778699
"3684","Fayette",17,17,8960,5692,39,14691,0.00505718180875834
"3685","Fentress",14,14,4293,2371,24,6688,0.00230225525403143
"3686","Franklin",18,18,9126,7797,81,17004,0.00585340136655958
"3687","Gibson",40,40,10596,8509,72,19177,0.00660142778208145
"3688","Giles",15,15,6162,5273,66,11501,0.00395906663824992
"3689","Grainger",11,11,4905,2569,27,7501,0.00258211971598232
"3690","Greene",40,40,16374,7625,97,24096,0.00829472825974004
"3691","Grundy",14,14,2102,2787,19,4908,0.00168951387362235
"3692","Hamblen",18,18,14733,7426,89,22248,0.00765857878165241
"3693","Hamilton",126,126,78513,57268,506,136287,0.0469149912987712
"3694","Hancock",8,8,1756,776,7,2539,0.000874017058909361
"3695","Hardeman",14,14,4702,5683,33,10418,0.00358625825904597
"3696","Hardin",19,19,6087,3834,22,9943,0.00342274581202669
"3697","Hawkins",22,22,13445,6683,64,20192,0.00695082806360686
"3698","Haywood",21,21,3140,4359,24,7523,0.00258969292405479
"3699","Henderson",16,16,6585,3448,39,10072,0.00346715235026982
"3700","Henry",14,14,7337,5728,64,13129,0.00451948403561284
"3701","Hickman",18,18,4359,4261,26,8646,0.00297627077248142
"3702","Houston",8,8,1438,2126,17,3581,0.00123271173216007
"3703","Humphreys",10,10,3261,4485,25,7771,0.00267506363323539
"3704","Jackson",17,17,2024,2996,14,5034,0.00173288770167378
"3705","Jefferson",11,11,11617,5469,73,17159,0.00590675805979745
"3706","Johnson",13,13,4632,1810,20,6462,0.00222445775292331
"3707","Knox",96,96,110653,65921,699,177273,0.0610238779377862
"3708","Lake",4,4,1039,1317,8,2364,0.000813775631060153
"3709","Lauderdale",17,17,4164,4472,0,8636,0.00297282840517575
"3710","Lawrence",30,30,9952,6592,57,16601,0.00571467396414112
"3711","Lewis",9,9,2819,2191,31,5041,0.00173529735878775
"3712","Lincoln",21,21,7827,4546,31,12404,0.00426991240595184
"3713","Loudon",16,16,14041,5706,57,19804,0.0068172642121469
"3714","Macon",10,10,4672,2739,18,7429,0.00255733467138151
"3715","Madison",33,33,21672,16837,92,38601,0.0132878820366129
"3716","Marion",29,29,5862,5548,45,11455,0.00394323174864385
"3717","Marshall",9,9,5825,4722,45,10592,0.00364615545016461
"3718","Maury",23,23,17495,12372,94,29961,0.0103136766845149
"3719","McMinn",16,16,11966,5878,79,17923,0.00616975492195056
"3720","McNairy",20,20,5787,4101,30,9918,0.00341413989376252
"3721","Meigs",7,7,2499,1595,21,4115,0.0014165341462828
"3722","Monroe",13,13,10113,5349,53,15515,0.00534083287474546
"3723","Montgomery",24,24,28615,20061,191,48867,0.0168218163126127
"3724","Moore",6,6,1667,1084,8,2759,0.000949749139634079
"3725","Morgan",13,13,4401,2924,0,7325,0.00252153405140255
"3726","Obion",13,13,7859,5549,65,13473,0.00463790147092785
"3727","Overton",16,16,3941,4518,27,8486,0.00292119289559072
"3728","Perry",11,11,1520,1579,25,3124,0.001075395546291
"3729","Pickett",10,10,1600,1033,10,2643,0.000909817678888318
"3730","Polk",12,12,3923,2724,27,6674,0.0022974359398035
"3731","Putnam",44,44,15619,10549,131,26299,0.00905308177717892
"3732","Rhea",16,16,7288,3663,41,10992,0.00378385014239137
"3733","Roane",26,26,14423,8676,87,23186,0.00798147283492416
"3734","Robertson",20,20,15329,9863,87,25279,0.00870196031200068
"3735","Rutherford",48,48,52189,31639,343,84171,0.0289747498485466
"3736","Scott",11,11,4508,3085,21,7614,0.00262101846653638
"3737","Sequatchie",11,11,2950,1986,21,4957,0.00170638147342013
"3738","Sevier",20,20,22127,8613,116,30856,0.0106217685583723
"3739","Shelby",283,283,157591,215810,1199,374600,0.128951079270361
"3740","Smith",9,9,3738,4038,26,7802,0.00268573497188296
"3741","Stewart",10,10,2675,2860,33,5568,0.0019167101157965
"3742","Sullivan",37,37,42526,19626,218,62370,0.0214700448854576
"3743","Sumner",37,37,40141,21439,213,61793,0.0212714202919205
"3744","Tipton",23,23,14178,7379,74,21631,0.00744618471889263
"3745","Trousdale",11,11,1314,1850,9,3173,0.00109226314608878
"3746","Unicoi",9,9,5026,2372,31,7429,0.00255733467138151
"3747","Union",10,10,4145,2524,16,6685,0.00230122254383973
"3748","Van Buren",8,8,1119,1209,9,2337,0.000804481239334847
"3749","Warren",22,22,7502,6803,60,14365,0.00494496063459353
"3750","Washington",41,41,29720,14937,176,44833,0.0154331653415059
"3751","Wayne",15,15,3998,1951,17,5966,0.00205371633456213
"3752","Weakley",10,10,7816,5584,56,13456,0.00463204944650822
"3753","White",12,12,5268,4147,49,9464,0.00325785641808515
"3754","Williamson",35,35,57409,21719,239,79367,0.0273210365949032
"3755","Wilson",36,36,28896,15256,143,44295,0.0152479659804609
"3756","Anderson",25,25,11495,4664,0,16159,0.00556252132923055
"3757","Andrews",5,5,3837,677,0,4514,0.00155388460177899
"3758","Angelina",47,47,18920,9293,0,28213,0.00971195087948397
"3759","Aransas",7,7,6567,2639,0,9206,0.00316904334159889
"3760","Archer",15,15,3545,877,0,4422,0.00152221482256683
"3761","Armstrong",8,8,826,170,0,996,0.000342859783644633
"3762","Atascosa",24,24,7596,4397,0,11993,0.00412843110968884
"3763","Austin",20,20,8064,2579,0,10643,0.00366371152342352
"3764","Bailey",7,7,1775,525,0,2300,0.000791744480303871
"3765","Bandera",11,11,6911,1730,0,8641,0.00297454958882859
"3766","Bastrop",22,22,13281,9785,0,23066,0.00794016442725613
"3767","Baylor",5,5,1169,467,0,1636,0.000563171291207449
"3768","Bee",18,18,5424,4041,0,9465,0.00325820065481571
"3769","Bell",48,48,51776,26941,0,78717,0.0270972827200347
"3770","Bexar",686,686,259762,210354,0,470116,0.161831194827189
"3771","Blanco",9,9,3271,1266,0,4537,0.00156180204658203
"3772","Borden",8,8,303,55,0,358,0.00012323674954295
"3773","Bosque",17,17,5720,1808,0,7528,0.00259141410770763
"3774","Bowie",37,37,21778,11872,0,33650,0.0115835659835762
"3775","Brazoria",76,76,63611,28873,0,92484,0.0318363897897492
"3776","Brazos",81,81,37523,16090,0,53613,0.0184555638358832
"3777","Brewster",9,9,1978,1726,0,3704,0.0012750528500198
"3778","Briscoe",7,7,619,191,0,810,0.00027883175175919
"3779","Brooks",10,10,844,1820,0,2664,0.000917046650230223
"3780","Brown",19,19,11638,2523,0,14161,0.00487473634155788
"3781","Burleson",16,16,4403,2275,0,6678,0.00229881288672576
"3782","Burnet",24,24,11449,4145,0,15594,0.00536802757646025
"3783","Caldwell",27,27,6429,5045,0,11474,0.00394977224652462
"3784","Calhoun",26,26,4347,2561,0,6908,0.00237798733475615
"3785","Callahan",8,8,4536,1072,0,5608,0.00193047958501918
"3786","Cameron",95,95,34689,33887,0,68576,0.0236063780353558
"3787","Camp",13,13,2636,1776,0,4412,0.00151877245526117
"3788","Carson",10,10,2446,485,0,2931,0.00100895785729159
"3789","Cass",26,26,7544,4667,0,12211,0.00420347471695242
"3790","Castro",10,10,1794,630,0,2424,0.000834429834894167
"3791","Chambers",14,14,8618,2951,0,11569,0.00398247473592847
"3792","Cherokee",29,29,11310,4432,0,15742,0.00541897461258415
"3793","Childress",5,5,1629,511,0,2140,0.000736666603413167
"3794","Clay",17,17,3964,1298,0,5262,0.00181137367624303
"3795","Cochran",7,7,856,249,0,1105,0.000380381587276425
"3796","Coke",5,5,1338,266,0,1604,0.000552155715829309
"3797","Coleman",15,15,3034,778,0,3812,0.00131223041692103
"3798","Collin",163,163,173014,68312,0,241326,0.0830732732407879
"3799","Collingsworth",8,8,1051,346,0,1397,0.00048089871260196
"3800","Colorado",13,13,5484,2159,0,7643,0.00263100133172282
"3801","Comal",27,27,31544,9138,0,40682,0.0140042386729227
"3802","Comanche",17,17,3710,1431,0,5141,0.00176972103184444
"3803","Concho",9,9,861,250,0,1111,0.000382447007659827
"3804","Cooke",26,26,11897,3136,0,15033,0.00517491077061222
"3805","Coryell",21,21,12359,5088,0,17447,0.00600589823820072
"3806","Cottle",6,6,549,214,0,763,0.000262652625422545
"3807","Crane",5,5,1314,254,0,1568,0.0005397631935289
"3808","Crockett",5,5,1248,473,0,1721,0.000592431413305636
"3809","Crosby",9,9,1647,621,0,2268,0.000780728904925731
"3810","Culberson",6,6,407,375,0,782,0.000269193123303316
"3811","Dallam",10,10,1370,305,0,1675,0.000576596523699559
"3812","Dallas",720,720,345482,335871,0,681353,0.234546729081949
"3813","Dawson",12,12,3419,1114,0,4533,0.00156042509965976
"3814","De Witt",17,17,5095,1610,0,6705,0.00230810727845107
"3815","Deaf Smith",9,9,4139,1133,0,5272,0.0018148160435487
"3816","Delta",11,11,1447,627,0,2074,0.000713946979195752
"3817","Denton",141,141,140541,59163,0,199704,0.0687454520411323
"3818","Dickens",7,7,815,245,0,1060,0.000364890934400915
"3819","Dimmit",8,8,1188,2365,0,3553,0.0012230731037042
"3820","Donley",10,10,1420,340,0,1760,0.000605856645797745
"3821","Duval",12,12,1160,2916,0,4076,0.00140310891379069
"3822","Eastland",10,10,5247,1582,0,6829,0.00235079263304136
"3823","Ector",36,36,27502,8579,0,36081,0.0124204054755843
"3824","Edwards",6,6,745,217,0,962,0.000331155734805358
"3825","El Paso",170,170,73046,94879,0,167925,0.0578059529804468
"3826","Ellis",46,46,34577,11618,0,46195,0.015902015768538
"3827","Erath",26,26,9499,2408,0,11907,0.00409882675086009
"3828","Falls",14,14,3378,2125,0,5503,0.00189433472830965
"3829","Fannin",20,20,7892,4000,0,11892,0.00409366319990158
"3830","Fayette",28,28,7526,2803,0,10329,0.00355562119002552
"3831","Fisher",11,11,1161,757,0,1918,0.000660246049227315
"3832","Floyd",11,11,2007,567,0,2574,0.000886065344479202
"3833","Foard",5,5,347,235,0,582,0.000200345777189936
"3834","Fort Bend",142,142,93554,68655,0,162209,0.0558382958285264
"3835","Franklin",9,9,2917,908,0,3825,0.00131670549441839
"3836","Freestone",16,16,5053,2070,0,7123,0.00245199823182803
"3837","Frio",11,11,1985,1928,0,3913,0.00134699832670828
"3838","Gaines",9,9,3538,608,0,4146,0.00142720548493037
"3839","Galveston",102,102,61290,43919,0,105209,0.0362168021862131
"3840","Garza",7,7,1479,326,0,1805,0.000621347298673256
"3841","Gillespie",15,15,9294,2102,0,11396,0.0039229217815404
"3842","Glasscock",5,5,488,44,0,532,0.000183133940661591
"3843","Goliad",12,12,2266,1219,0,3485,0.00119966500602565
"3844","Gonzales",16,16,4290,1707,0,5997,0.0020643876732097
"3845","Gray",8,8,7258,1289,0,8547,0.0029421913361553
"3846","Grayson",55,55,34679,15062,0,49741,0.0171226792151282
"3847","Gregg",24,24,29931,12297,0,42228,0.0145364286583791
"3848","Grimes",15,15,5263,2713,0,7976,0.0027456321630016
"3849","Guadalupe",31,31,28192,10280,0,38472,0.0132434754983698
"3850","Hale",30,30,8011,2074,0,10085,0.00347162742776719
"3851","Hall",8,8,858,412,0,1270,0.000437180647819964
"3852","Hamilton",12,12,2855,845,0,3700,0.00127367590309753
"3853","Hansford",9,9,1892,243,0,2135,0.000734945419760333
"3854","Hardeman",6,6,1214,480,0,1694,0.00058313702158033
"3855","Hardin",20,20,14844,5519,0,20363,0.0070096925445338
"3856","Harris",914,914,580553,472320,0,1052873,0.362437559222164
"3857","Harrison",30,30,16456,9637,0,26093,0.00898216901068214
"3858","Hartley",7,7,1735,315,0,2050,0.000705685297662146
"3859","Haskell",11,11,1137,611,0,1748,0.000601725805030942
"3860","Hays",37,37,26991,20086,0,47077,0.016205632564898
"3861","Hemphill",9,9,1380,257,0,1637,0.000563515527938016
"3862","Henderson",32,32,20182,8496,0,28678,0.00987202095919758
"3863","Hidalgo",141,141,51438,63035,0,114473,0.0394058112581848
"3864","Hill",26,26,9223,3750,0,12973,0.0044657831056444
"3865","Hockley",17,17,6158,1385,0,7543,0.00259657765866613
"3866","Hood",16,16,16265,4862,0,21127,0.00727268940668691
"3867","Hopkins",22,22,8580,3439,0,12019,0.00413738126468358
"3868","Houston",22,22,5848,2921,0,8769,0.00301861189034115
"3869","Howard",20,20,7479,2663,0,10142,0.00349124892140951
"3870","Hudspeth",6,6,577,302,0,879,0.000302584086168306
"3871","Hunt",37,37,20065,7971,0,28036,0.00965102097817363
"3872","Hutchinson",9,9,7829,1501,0,9330,0.00321172869618918
"3873","Irion",6,6,684,141,0,825,0.000283995302717693
"3874","Jack",11,11,2469,642,0,3111,0.00107092046879363
"3875","Jackson",13,13,3763,1296,0,5059,0.00174149361993795
"3876","Jasper",21,21,8328,4459,0,12787,0.00440175507375896
"3877","Jeff Davis",6,6,764,378,0,1142,0.000393118346307401
"3878","Jefferson",107,107,44412,47050,0,91462,0.0314845798511099
"3879","Jim Hogg",6,6,712,1344,0,2056,0.000707750718045548
"3880","Jim Wells",22,22,5808,6824,0,12632,0.00434839838052109
"3881","Johnson",35,35,34739,12311,0,47050,0.0161963381731727
"3882","Jones",15,15,4234,1657,0,5891,0.00202789857976961
"3883","Karnes",16,16,3112,1542,0,4654,0.00160207774405836
"3884","Kaufman",43,43,21292,8947,0,30239,0.0104093744956125
"3885","Kendall",12,12,11428,2531,0,13959,0.00480520052198337
"3886","Kenedy",7,7,82,85,0,167,5.74875340046724e-05
"3887","Kent",5,5,382,138,0,520,0.000179003099894788
"3888","Kerr",21,21,16519,4552,0,21071,0.00725341214977516
"3889","Kimble",8,8,1479,324,0,1803,0.000620658825212122
"3890","King",5,5,137,18,0,155,5.33566932378696e-05
"3891","Kinney",5,5,1050,542,0,1592,0.000548024875062506
"3892","Kleberg",34,34,5379,4552,0,9931,0.00341861497125989
"3893","Knox",11,11,1079,464,0,1543,0.000531157275264728
"3894","La Salle",7,7,989,1229,0,2218,0.000763517068397386
"3895","La Vaca",20,20,5974,2151,0,8125,0.00279692343585607
"3896","Lamar",32,32,12039,5335,0,17374,0.00598076895686933
"3897","Lamb",13,13,3392,855,0,4247,0.00146197339471763
"3898","Lampasas",11,11,5417,1591,0,7008,0.00241241100781284
"3899","Lee",16,16,4157,1899,0,6056,0.00208469764031315
"3900","Leon",15,15,5012,1750,0,6762,0.00232772877209338
"3901","Liberty",37,37,14798,6777,0,21575,0.00742690746198088
"3902","Limestone",23,23,5028,2752,0,7780,0.00267816176381049
"3903","Lipscomb",10,10,1147,184,0,1331,0.000458179088384545
"3904","Live Oak",15,15,3144,1034,0,4178,0.00143822106030851
"3905","Llano",13,13,7231,2255,0,9486,0.00326542962615762
"3906","Loving",5,5,65,12,0,77,2.65062282536514e-05
"3907","Lubbock",89,89,69675,22331,0,92006,0.0316718446325383
"3908","Lynn",15,15,1745,465,0,2210,0.00076076317455285
"3909","Madison",9,9,2828,1233,0,4061,0.00139794536283218
"3910","Marion",11,11,2434,1875,0,4309,0.00148331607201278
"3911","Martin",7,7,1511,293,0,1804,0.000621003061942689
"3912","Mason",5,5,1599,459,0,2058,0.000708439191506682
"3913","Matagorda",19,19,8114,4347,0,12461,0.00428953389959415
"3914","Maverick",15,15,4025,5948,0,9973,0.0034330729139437
"3915","McCulloch",11,11,2465,745,0,3210,0.00110499990511975
"3916","McLennan",93,93,52078,26759,0,78837,0.0271385911277027
"3917","McMullen",6,6,467,95,0,562,0.000193461042578598
"3918","Medina",23,23,10385,4316,0,14701,0.00506062417606401
"3919","Menard",7,7,761,331,0,1092,0.000375906509779056
"3920","Midland",39,39,36548,7994,0,44542,0.0153329924529109
"3921","Milam",12,12,5280,3435,0,8715,0.00300002310689054
"3922","Mills",11,11,1820,439,0,2259,0.000777630774350629
"3923","Mitchell",7,7,1911,639,0,2550,0.000877803662945597
"3924","Montague",16,16,5901,1944,0,7845,0.00270053715129734
"3925","Montgomery",86,86,104361,28561,0,132922,0.0457566347004136
"3926","Moore",8,8,4598,1009,0,5607,0.00193013534828861
"3927","Morris",10,10,2814,2435,0,5249,0.00180689859874566
"3928","Motley",7,7,564,113,0,677,0.000233048266593792
"3929","Nacogdoches",35,35,13964,7077,0,21041,0.00724308504785816
"3930","Navarro",35,35,10706,5256,0,15962,0.00549470669330887
"3931","Newton",23,23,3147,2510,0,5657,0.00194734718481696
"3932","Nolan",15,15,3722,1541,0,5263,0.0018117179129736
"3933","Nueces",127,127,59337,44408,0,103745,0.0357128396126631
"3934","Ochiltree",5,5,2920,251,0,3171,0.00109157467262764
"3935","Oldham",8,8,733,108,0,841,0.000289503090406763
"3936","Orange",35,35,20272,11469,0,31741,0.010926418064924
"3937","Palo Pinto",31,31,7137,2816,0,9953,0.00342618817933236
"3938","Panola",22,22,7020,2958,0,9978,0.00343479409759653
"3939","Parker",44,44,31759,8948,0,40707,0.0140128445911868
"3940","Parmer",10,10,3340,542,0,3882,0.00133632698806071
"3941","Pecos",10,10,3160,1241,0,4401,0.00151498585122493
"3942","Polk",21,21,13778,6954,0,20732,0.00713671589811298
"3943","Potter",26,26,21033,7487,0,28520,0.00981763155576801
"3944","Presidio",8,8,713,1156,0,1869,0.000643378449429537
"3945","Rains",8,8,2995,1213,0,4208,0.00144854816222552
"3946","Randall",31,31,40512,7842,0,48354,0.0166452228698319
"3947","Reagan",7,7,955,184,0,1139,0.0003920856361157
"3948","Real",7,7,1338,326,0,1664,0.000572809919663323
"3949","Red River",25,25,3377,2097,0,5474,0.00188435186312321
"3950","Reeves",12,12,1777,1600,0,3377,0.00116248743912442
"3951","Refugio",11,11,2163,1205,0,3368,0.00115938930854932
"3952","Roberts",6,6,428,39,0,467,0.000160758553174743
"3953","Robertson",17,17,3781,2977,0,6758,0.00232635182517111
"3954","Rockwall",17,17,20111,5318,0,25429,0.00875359582158572
"3955","Runnels",11,11,3238,787,0,4025,0.00138555284053178
"3956","Rusk",38,38,13386,4895,0,18281,0.00629299167149351
"3957","Sabine",11,11,3134,1476,0,4610,0.00158693132791341
"3958","San Augustine",12,12,2231,1506,0,3737,0.00128641266212851
"3959","San Jacinto",12,12,5391,2688,0,8079,0.00278108854624999
"3960","San Patricio",33,33,13464,7758,0,21222,0.00730539189609077
"3961","San Saba",8,8,1814,446,0,2260,0.000777975011081196
"3962","Schleicher",5,5,1011,312,0,1323,0.00045542519454001
"3963","Scurry",12,12,4576,981,0,5557,0.00191292351176027
"3964","Shackelford",8,8,1281,222,0,1503,0.000517387806042052
"3965","Shelby",15,15,6287,2943,0,9230,0.00317730502313249
"3966","Sherman",8,8,942,121,0,1063,0.000365923644592615
"3967","Smith",78,78,53321,19937,0,73258,0.02521809440787
"3968","Somervell",7,7,2692,827,0,3519,0.00121136905486492
"3969","Starr",11,11,2552,7199,0,9751,0.00335665235975785
"3970","Stephens",9,9,2803,703,0,3506,0.00120689397736755
"3971","Sterling",5,5,544,76,0,620,0.000213426772951478
"3972","Stonewall",10,10,356,253,0,609,0.000209640168915243
"3973","Sutton",7,7,1173,280,0,1453,0.000500175969513707
"3974","Swisher",11,11,916,407,0,1323,0.00045542519454001
"3975","Tarrant",635,635,349294,207184,0,556478,0.191560167352408
"3976","Taylor",36,36,37191,10645,0,47836,0.0164669082433983
"3977","Terrell",5,5,306,159,0,465,0.000160070079713609
"3978","Terry",9,9,3166,794,0,3960,0.00136317745304493
"3979","Throckmorton",6,6,656,202,0,858,0.000295355114826401
"3980","Titus",20,20,5704,3173,0,8877,0.00305578945724238
"3981","Tom Green",61,61,28087,8971,0,37058,0.0127567247613482
"3982","Travis",262,262,147625,196780,0,344405,0.118556851190893
"3983","Trinity",20,20,3983,2204,0,6187,0.00212979265201741
"3984","Tyler",18,18,5012,2645,0,7657,0.00263582064595076
"3985","Upshur",21,21,10222,4218,0,14440,0.00497077838938605
"3986","Upton",7,7,1008,185,0,1193,0.000410674419566312
"3987","Uvalde",16,16,5147,3297,0,8444,0.00290673495290691
"3988","Val Verde",18,18,6923,4750,0,11673,0.00401827535590743
"3989","Van Zandt",29,29,14966,4820,0,19786,0.0068110679509967
"3990","Victoria",36,36,20860,8552,0,29412,0.0101246907194337
"3991","Walker",19,19,11692,5966,0,17658,0.00607853218835033
"3992","Waller",19,19,7680,6145,0,13825,0.0047590728000874
"3993","Ward",9,9,2855,901,0,3756,0.00129295316000928
"3994","Washington",31,31,9590,3387,0,12977,0.00446716005256667
"3995","Webb",58,58,17733,23636,0,41369,0.0142407293068221
"3996","Wharton",23,23,9288,4702,0,13990,0.00481587186063094
"3997","Wheeler",11,11,1953,408,0,2361,0.000812742920868452
"3998","Wichita",36,36,32472,12819,0,45291,0.0155908257641055
"3999","Wilbarger",13,13,3685,1284,0,4969,0.00171051231418693
"4000","Willacy",13,13,2980,4843,0,7823,0.00269296394322486
"4001","Williamson",93,93,83079,42986,0,126065,0.0433962034389163
"4002","Wilson",25,25,10379,4404,0,14783,0.00508885158797049
"4003","Winkler",6,6,1601,391,0,1992,0.000685719567289266
"4004","Wise",23,23,15162,4776,0,19938,0.00686339193404287
"4005","Wood",13,13,12826,4030,0,16856,0.00580245433043568
"4006","Yoakum",7,7,2228,376,0,2604,0.000896392446396209
"4007","Young",13,13,5856,1505,0,7361,0.00253392657370296
"4008","Zapata",8,8,1228,1661,0,2889,0.000994499914607776
"4009","Zavala",7,7,777,2332,0,3109,0.00107023199533249
"4010","Beaver",7,7,1975,486,12,2473,0.000851297434691945
"4011","Box Elder",46,46,15244,2169,142,17555,0.00604307580510194
"4012","Cache",72,72,31379,6131,388,37898,0.0130458836150244
"4013","Carbon",23,23,4856,3378,82,8316,0.00286267265139435
"4014","Daggett",3,3,376,106,6,488,0.000167987524516648
"4015","Davis",212,212,84390,20384,1023,105797,0.0364192133837864
"4016","Duchesne",14,14,4590,707,24,5321,0.00183168364334648
"4017","Emery",12,12,3772,830,25,4627,0.00159278335233305
"4018","Garfield",10,10,1839,260,22,2121,0.000730126105532396
"4019","Grand",11,11,2073,1782,112,3967,0.00136558711015889
"4020","Iron",33,33,12422,2208,103,14733,0.00507163975144215
"4021","Juab",11,11,2659,601,20,3280,0.00112909647625943
"4022","Kane",12,11,2325,540,24,2889,0.000994499914607776
"4023","Millard",17,17,3905,591,27,4523,0.00155698273235409
"4024","Morgan",8,8,3252,468,25,3745,0.00128916655597304
"4025","Piute",5,5,642,123,3,768,0.00026437380907538
"4026","Rich",5,5,895,106,5,1006,0.000346302150950302
"4027","Salt Lake",743,743,209162,131057,5786,346005,0.1191076299598
"4028","San Juan",20,20,2908,1838,28,4774,0.00164338615172638
"4029","Sanpete",27,27,6866,1158,56,8080,0.00278143278298056
"4030","Sevier",23,23,6458,902,37,7397,0.00254631909600336
"4031","Summit",36,36,7731,6754,256,14741,0.00507439364528668
"4032","Tooele",38,38,11751,4010,143,15904,0.00547474096293599
"4033","Uintah",26,26,8378,1251,42,9671,0.0033291134213125
"4034","Utah",248,248,95039,11893,1221,108153,0.037230235121002
"4035","Wasatch",19,19,5392,1825,60,7277,0.00250501068833534
"4036","Washington",75,75,31747,6371,273,38391,0.0132155923231939
"4037","Wayne",7,7,1059,278,10,1347,0.000463686876073615
"4038","Weber",150,146,49538,19079,885,69502,0.0239251412478607
"4039","Accomack",21,21,7724,5517,0,13241,0.00455803854943633
"4040","Albemarle",29,29,21180,22069,0,43249,0.0148878943602879
"4041","Alexandria",25,25,19764,40807,0,60571,0.0208507630071677
"4042","Alleghany",12,12,3953,3199,0,7152,0.00246198109701447
"4043","Amelia",5,5,3499,1862,0,5361,0.00184545311256915
"4044","Amherst",12,12,7756,4864,0,12620,0.00434426753975429
"4045","Appomattox",9,9,4366,2171,0,6537,0.00225027550771583
"4046","Arlington",46,46,29545,63705,0,93250,0.0321000751253635
"4047","Augusta",26,26,22099,7019,0,29118,0.010023485120647
"4048","Bath",8,8,1419,820,0,2239,0.000770746039739291
"4049","Bedford",30,30,21921,9050,0,30971,0.0106613557823875
"4050","Bedford City",2,2,1470,1042,0,2512,0.000864722667184054
"4051","Bland",7,7,1962,846,0,2808,0.000966616739431857
"4052","Botetourt",17,17,10865,4801,0,15666,0.00539281262106107
"4053","Bristol",5,5,4273,2399,0,6672,0.00229674746634236
"4054","Brunswick",13,13,2852,4062,0,6914,0.00238005275513955
"4055","Buchanan",18,18,4401,5267,0,9668,0.0033280807111208
"4056","Buckingham",9,9,3185,2807,0,5992,0.00206266648955687
"4057","Buena Vista",2,2,1447,936,0,2383,0.000820316128940924
"4058","Campbell",17,17,15874,6862,0,22736,0.00782656630616905
"4059","Caroline",9,9,4968,4848,0,9816,0.0033790277472447
"4060","Carroll",18,18,7751,3661,0,11412,0.00392842956922947
"4061","Charles City",3,3,1254,2155,0,3409,0.00117350301450256
"4062","Charlotte",10,10,3165,2220,0,5385,0.00185371479410276
"4063","Charlottesville",9,9,4155,11015,0,15170,0.00522207120269988
"4064","Chesapeake",50,50,51913,38442,0,90355,0.0311035097903723
"4065","Chesterfield",63,63,78912,46372,0,125284,0.0431273545523436
"4066","Clarke",8,8,3741,2699,0,6440,0.00221688454485084
"4067","Colonial Heights",5,5,6127,2061,0,8188,0.00281861034988178
"4068","Covington",5,5,1104,1179,0,2283,0.000785892455884234
"4069","Craig",11,11,1689,894,0,2583,0.000889163475054304
"4070","Culpeper",13,13,9635,5218,0,14853,0.00511294815911018
"4071","Cumberland",5,5,2377,1721,0,4098,0.00141068212186316
"4072","Danville",18,18,9399,9435,0,18834,0.00648335458349701
"4073","Dickenson",13,13,3587,3760,0,7347,0.00252910725947502
"4074","Dinwiddie",13,13,6193,4569,0,10762,0.00370467569436099
"4075","Emporia",7,7,970,1247,0,2217,0.000763172831666819
"4076","Essex",4,4,2304,2007,0,4311,0.00148400454547391
"4077","Fairfax",225,225,189371,215223,0,404594,0.139276115766985
"4078","Fairfax City",7,7,5042,5393,0,10435,0.00359211028346561
"4079","Falls Church",5,5,2072,3937,0,6009,0.00206851851397651
"4080","Fauquier",19,19,17713,9830,0,27543,0.00948131227000414
"4081","Floyd",5,5,4162,2487,0,6649,0.00228883002153932
"4082","Fluvanna",6,6,6456,4413,0,10869,0.00374150902453164
"4083","Franklin",23,23,14048,8001,0,22049,0.00759007567226959
"4084","Franklin City",6,6,1611,1909,0,3520,0.00121171329159549
"4085","Frederick",20,20,19375,8848,0,28223,0.00971539324678964
"4086","Fredericksburg",5,5,3383,4075,0,7458,0.00256731753656794
"4087","Galax",3,3,1336,986,0,2322,0.000799317688376343
"4088","Giles",9,9,4319,3046,0,7365,0.00253530352062522
"4089","Gloucester",11,11,11080,5103,0,16183,0.00557078301076415
"4090","Goochland",8,8,6665,3583,0,10248,0.0035277380148496
"4091","Grayson",15,15,4655,2430,0,7085,0.00243891723606649
"4092","Greene",4,4,4570,2240,0,6810,0.00234425213516059
"4093","Greensville",9,9,1715,2599,0,4314,0.00148503725566561
"4094","Halifax",21,21,8358,6220,0,14578,0.00501828305820428
"4095","Hampton",31,31,23008,31750,0,54758,0.0188497148923823
"4096","Hanover",34,34,35398,13911,0,49309,0.0169739689475233
"4097","Harrisonburg",5,5,5815,4390,0,10205,0.00351293583543522
"4098","Henrico",91,91,71264,60813,0,132077,0.0454657546630845
"4099","Henry",25,25,13358,9846,0,23204,0.00798766909607436
"4100","Highland",8,8,982,522,0,1504,0.000517732042772619
"4101","Hopewell",7,7,4250,3572,0,7822,0.0026926197064943
"4102","Isle of Wight",13,13,9933,5870,0,15803,0.00543997305314873
"4103","James City",11,11,17323,10893,0,28216,0.00971298358967567
"4104","King and Queen",5,5,1737,1505,0,3242,0.00111601548049789
"4105","King George",5,5,5144,2739,0,7883,0.00271361814705888
"4106","King William",6,6,4397,2434,0,6831,0.0023514811065025
"4107","Lancaster",7,7,3724,2476,0,6200,0.00213426772951478
"4108","Lee",19,19,5663,4000,0,9663,0.00332635952746796
"4109","Lexington",1,1,982,1340,0,2322,0.000799317688376343
"4110","Loudoun",53,53,60360,47072,0,107432,0.0369820404382633
"4111","Louisa",14,14,7188,4874,0,12062,0.00415218344409796
"4112","Lunenburg",11,11,2858,2362,0,5220,0.00179691573355922
"4113","Lynchburg",18,18,13540,10986,0,24526,0.00844275005388381
"4114","Madison",9,9,3556,2175,0,5731,0.00197282070287891
"4115","Manassas",6,6,7154,5498,0,12652,0.00435528311513243
"4116","Manassas Park",1,1,1803,1496,0,3299,0.00113563697414021
"4117","Martinsville",7,7,2538,3036,0,5574,0.0019187755361799
"4118","Mathews",4,4,3497,1589,0,5086,0.00175078801166326
"4119","Mecklenburg",23,23,7314,5310,0,12624,0.00434564448667655
"4120","Middlesex",7,7,3335,1913,0,5248,0.00180655436201509
"4121","Montgomery",21,21,16205,13106,0,29311,0.0100899228096464
"4122","Nelson",10,10,3539,3543,0,7082,0.00243788452587479
"4123","New Kent",10,10,5411,2439,0,7850,0.00270225833495017
"4124","Newport News",46,46,30081,33598,0,63679,0.0219206507657697
"4125","Norfolk",56,56,26156,42979,0,69135,0.0237988063677427
"4126","Northampton",6,6,2669,2775,0,5444,0.00187402476120621
"4127","Northumberland",6,6,3830,2546,0,6376,0.00219485339409456
"4128","Norton",2,2,768,725,0,1493,0.000513945438736383
"4129","Nottoway",9,9,3303,2636,0,5939,0.00204442194283682
"4130","Orange",8,8,7749,5005,0,12754,0.00439039526165025
"4131","Page",5,5,6221,3324,0,9545,0.00328573959326107
"4132","Patrick",13,13,5506,2572,0,8078,0.00278074430951942
"4133","Petersburg",7,7,1853,8345,0,10198,0.00351052617832125
"4134","Pittsylvania",32,32,17692,9370,0,27062,0.00931573440260147
"4135","Poquoson",3,3,5003,1424,0,6427,0.00221240946735347
"4136","Portsmouth",31,31,15217,24113,0,39330,0.0135388306131962
"4137","Powhatan",10,10,8955,3112,0,12067,0.00415390462775079
"4138","Prince Edward",10,10,3571,3628,0,7199,0.00247816022335112
"4139","Prince George",11,11,8132,5053,0,13185,0.00453876129252458
"4140","Prince William",62,62,65367,57425,0,122792,0.0422695166197709
"4141","Pulaski",13,13,8766,5309,0,14075,0.00484513198272913
"4142","Radford",3,3,2564,2173,0,4737,0.00163064939269541
"4143","Rappahannock",6,6,2172,1837,0,4009,0.0013800450528427
"4144","Richmond",7,7,2082,1243,0,3325,0.00114458712913494
"4145","Richmond City",69,69,20606,49731,0,70337,0.0242125789178841
"4146","Roanoke",33,33,30589,16079,0,46668,0.0160648397420961
"4147","Roanoke City",33,33,15761,17796,0,33557,0.0115515519676335
"4148","Rockbridge",17,17,5412,3637,0,9049,0.00311499817489988
"4149","Rockingham",27,27,20815,6769,0,27584,0.00949542597595739
"4150","Russell",15,15,6074,5164,0,11238,0.00386853237811083
"4151","Salem",11,11,7075,4215,0,11290,0.00388643268810031
"4152","Scott",17,17,6477,3321,0,9798,0.00337283148609449
"4153","Shenandoah",15,15,11805,5182,0,16987,0.00584754934213994
"4154","Smyth",15,15,7790,4258,0,12048,0.00414736412987002
"4155","Southampton",14,14,4018,3431,0,7449,0.00256421940599284
"4156","Spotsylvania",26,26,28520,16616,0,45136,0.0155374690708676
"4157","Stafford",22,22,26433,15928,0,42361,0.0145822121435445
"4158","Staunton",6,6,5805,3756,0,9561,0.00329124738095014
"4159","Suffolk",23,23,16031,14074,0,30105,0.0103632467737165
"4160","Surry",7,7,1543,1954,0,3497,0.00120379584679245
"4161","Sussex",11,11,1882,2411,0,4293,0.0014778082843237
"4162","Tazewell",25,25,10033,7175,0,17208,0.00592362565959523
"4163","Virginia Beach",86,86,103748,70657,0,174405,0.0600366069945203
"4164","Warren",12,12,8599,5239,0,13838,0.00476354787758477
"4165","Washington",18,18,14742,7338,0,22080,0.00760074701091717
"4166","Waynesboro",5,5,5090,2787,0,7877,0.00271155272667548
"4167","Westmoreland",6,6,3205,3132,0,6337,0.00218142816160245
"4168","Williamsburg",2,2,1960,2211,0,4171,0.00143581140319454
"4169","Winchester",6,6,5283,3967,0,9250,0.00318418975774383
"4170","Wise",12,12,8337,5792,0,14129,0.00486372076617974
"4171","Wythe",13,13,7911,3581,0,11492,0.00395596850767482
"4172","York",13,13,17991,9470,0,27461,0.00945308485809766
"4173","Addison",1,1,407,333,6,746,0.000256800601002908
"4174","Albany",1,1,204,265,6,475,0.000163512447019278
"4175","Alburg",1,1,437,446,15,898,0.000309124584049077
"4176","Andover",1,1,128,173,2,303,0.000104303729361771
"4177","Arlington",1,1,582,739,14,1335,0.000459556035306812
"4178","Athens",1,1,61,75,2,138,4.75046688182323e-05
"4179","Bakersfield",1,1,273,329,16,618,0.000212738299490345
"4180","Baltimore",1,1,65,53,4,122,4.19968811291619e-05
"4181","Barnard",1,1,223,333,6,562,0.000193461042578598
"4182","Barnet",1,1,433,469,16,918,0.000316009318660415
"4183","Barre",3,3,1703,2037,43,3783,0.00130224755173459
"4184","Barre Town",1,1,2228,1908,40,4176,0.00143753258684738
"4185","Barton",1,1,606,648,19,1273,0.000438213358011665
"4186","Belvidere",1,1,72,66,5,143,4.92258524710668e-05
"4187","Bennington",1,1,2471,4251,88,6810,0.00234425213516059
"4188","Benson",1,1,251,256,5,512,0.000176249206050253
"4189","Berkshire",1,1,321,302,10,633,0.000217901850448848
"4190","Berlin",1,1,588,722,19,1329,0.000457490614923411
"4191","Bethel",1,1,400,596,14,1010,0.00034767909787257
"4192","Bloomfield",1,1,52,54,4,110,3.78660403623591e-05
"4193","Bolton",1,1,234,384,8,626,0.00021549219333488
"4194","Bradford",1,1,632,659,10,1301,0.000447851986467538
"4195","Braintree",1,1,285,307,6,598,0.000205853564879007
"4196","Brandon",1,1,851,1054,28,1933,0.000665409600185819
"4197","Brattleboro",3,3,1408,4499,98,6005,0.00206714156705424
"4198","Bridgewater",1,1,248,288,6,542,0.00018657630796726
"4199","Bridport",1,1,350,337,10,697,0.00023993300120513
"4200","Brighton",1,1,316,277,8,601,0.000206886275070707
"4201","Bristol",1,1,746,1151,18,1915,0.000659213339035615
"4202","Brookfield",1,1,317,399,10,726,0.00024991586639157
"4203","Brookline",1,1,110,164,11,285,9.81074682115667e-05
"4204","Brownington",1,1,193,172,6,371,0.00012771182704032
"4205","Brunswick",1,1,26,34,0,60,2.0654203834014e-05
"4206","Burke",1,1,369,411,11,791,0.000272291253878418
"4207","Burlington",7,7,3976,14290,574,18840,0.00648542000388041
"4208","Cabot",1,1,225,449,14,688,0.000236834870630028
"4209","Calais",1,1,259,733,19,1011,0.000348023334603137
"4210","Cambridge",1,1,602,1097,43,1742,0.000599660384647541
"4211","Canaan",1,1,199,235,10,444,0.000152841108371704
"4212","Castleton",1,1,894,949,34,1877,0.000646132343274073
"4213","Cavendish",1,1,328,383,10,721,0.000248194682738735
"4214","Charleston",1,1,218,213,3,434,0.000149398741066035
"4215","Charlotte",1,1,707,1548,33,2288,0.000787613639537069
"4216","Chelsea",1,1,333,361,8,702,0.000241654184857964
"4217","Chester",1,1,613,990,27,1630,0.000561105870824048
"4218","Chittenden",1,1,343,366,3,712,0.000245096552163633
"4219","Clarendon",1,1,762,579,13,1354,0.000466096533187583
"4220","Colchester",1,1,3118,4400,49,7567,0.00260483934019974
"4221","Concord",1,1,299,199,14,512,0.000176249206050253
"4222","Corinth",1,1,300,373,13,686,0.000236146397168894
"4223","Cornwall",1,1,230,488,11,729,0.000250948576583271
"4224","Coventry",1,1,204,184,3,391,0.000134596561651658
"4225","Craftsbury",1,1,216,430,14,660,0.000227196242174154
"4226","Danby",1,1,360,356,9,725,0.000249571629661003
"4227","Danville",1,1,639,594,13,1246,0.000428918966286358
"4228","Derby",1,1,1012,1104,26,2142,0.000737355076874301
"4229","Dorset",1,1,537,733,13,1283,0.000441655725317334
"4230","Dover",1,1,334,382,9,725,0.000249571629661003
"4231","Dummerston",1,1,317,790,17,1124,0.000386922085157196
"4232","Duxbury",1,1,272,436,11,719,0.000247506209277602
"4233","East Haven",1,1,83,56,3,142,4.88816157404999e-05
"4234","East Montpelier",1,1,538,992,24,1554,0.000534943879300964
"4235","Eden",1,1,212,243,7,462,0.000159037369521908
"4236","Elmore",1,1,145,308,5,458,0.000157660422599641
"4237","Enosburgh",1,1,449,621,13,1083,0.000372808379203953
"4238","Essex",2,2,4336,5744,116,10196,0.00350983770486012
"4239","Fair Haven",1,1,595,627,21,1243,0.000427886256094658
"4240","Fairfax",1,1,849,1062,34,1945,0.000669540440952622
"4241","Fairfield",1,1,344,554,4,902,0.000310501530971344
"4242","Fairlee",1,1,223,361,1,585,0.000201378487381637
"4243","Fayston",1,1,232,529,13,774,0.000266439229458781
"4244","Ferrisburg",1,1,692,800,12,1504,0.000517732042772619
"4245","Fletcher",1,1,248,341,5,594,0.000204476617956739
"4246","Franklin",1,1,301,253,8,562,0.000193461042578598
"4247","Georgia",1,1,1102,1013,24,2139,0.0007363223666826
"4248","Glover",1,1,246,285,8,539,0.000185543597775559
"4249","Goshen",1,1,49,82,2,133,4.57834851653978e-05
"4250","Grafton",1,1,133,217,4,354,0.000121859802620683
"4251","Granby",1,1,45,7,0,52,1.79003099894788e-05
"4252","Grand Isle",1,1,502,666,13,1181,0.00040654357879951
"4253","Granville",1,1,39,113,3,155,5.33566932378696e-05
"4254","Greensboro",1,1,148,263,7,418,0.000143890953376964
"4255","Groton",1,1,283,170,4,457,0.000157316185869074
"4256","Guildhall",1,1,82,54,0,136,4.68161953570985e-05
"4257","Guilford",1,1,380,812,14,1206,0.000415149497063682
"4258","Halifax",1,1,172,245,6,423,0.000145612137029799
"4259","Hancock",1,1,69,111,4,184,6.33395584243097e-05
"4260","Hardwick",1,1,642,874,11,1527,0.000525649487575657
"4261","Hartford",1,1,1891,2909,40,4840,0.0016661057759438
"4262","Hartland",1,1,680,1104,41,1825,0.000628232033284594
"4263","Highgate",1,1,667,602,11,1280,0.000440623015125633
"4264","Hinesburg",1,1,496,1502,40,2038,0.000701554456895344
"4265","Holland",1,1,141,152,3,296,0.000101894072247803
"4266","Hubbardton",1,1,151,177,7,335,0.000115319304739912
"4267","Huntington",1,1,334,702,20,1056,0.000363513987478647
"4268","Hyde Park",1,1,544,933,14,1491,0.000513256965275249
"4269","Ira",1,1,98,104,2,204,7.02242930356477e-05
"4270","Irasburg",1,1,300,260,2,562,0.000193461042578598
"4271","Isle La Motte",1,1,143,167,0,310,0.000106713386475739
"4272","Jamaica",1,1,167,311,14,492,0.000169364471438915
"4273","Jay",1,1,78,125,0,203,6.98800563050808e-05
"4274","Jericho",1,1,1128,1803,33,2964,0.00102031766940029
"4275","Johnson",1,1,494,970,34,1498,0.000515666622389217
"4276","Killington",1,1,261,378,7,646,0.000222376927946218
"4277","Kirby",1,1,88,135,5,228,7.84859745692533e-05
"4278","Landgrove",1,1,20,91,0,111,3.8210277092926e-05
"4279","Leicester",1,1,277,277,8,562,0.000193461042578598
"4280","Lemington",1,1,32,20,0,52,1.79003099894788e-05
"4281","Lincoln",1,1,253,513,14,780,0.000268504649842183
"4282","Londonderry",1,1,446,529,14,989,0.000340450126530665
"4283","Lowell",1,1,152,178,1,331,0.000113942357817644
"4284","Ludlow",1,1,593,664,10,1267,0.000436147937628263
"4285","Lunenburg",1,1,314,252,7,573,0.000197247646614834
"4286","Lyndon",1,1,1144,1029,27,2200,0.000757320807247181
"4287","Maidstone",1,1,47,36,2,85,2.92601220981866e-05
"4288","Manchester",1,1,1037,1309,26,2372,0.000816529524904688
"4289","Marlboro",1,1,89,452,17,558,0.000192084095656331
"4290","Marshfield",1,1,344,526,18,888,0.000305682216743408
"4291","Mendon",1,1,300,337,5,642,0.00022099998102395
"4292","Middlebury",1,1,933,2390,37,3360,0.00115663541470479
"4293","Middlesex",1,1,323,701,22,1046,0.000360071620172978
"4294","Middletown Springs",1,1,207,262,5,474,0.000163168210288711
"4295","Milton",1,1,2253,2130,59,4442,0.00152909955717817
"4296","Monkton",1,1,378,696,14,1088,0.000374529562856788
"4297","Montgomery",1,1,224,390,18,632,0.000217557613718281
"4298","Montpelier",1,1,1048,3536,87,4671,0.00160792976847799
"4299","Moretown",1,1,341,608,19,968,0.00033322115518876
"4300","Morgan",1,1,199,159,2,360,0.000123925223004084
"4301","Morristown",1,1,878,1545,29,2452,0.00084406846335004
"4302","Mount Holly",1,1,334,387,11,732,0.000251981286774971
"4303","Mount Tabor",1,1,60,49,1,110,3.78660403623591e-05
"4304","New Haven",1,1,404,567,9,980,0.000337351995955563
"4305","Newark",1,1,108,143,10,261,8.98457866779611e-05
"4306","Newbury",1,1,507,583,9,1099,0.000378316166893024
"4307","Newfane",1,1,304,713,1,1018,0.000350432991717105
"4308","Newport",1,1,835,887,17,1739,0.00059862767445584
"4309","Newport Town",1,1,392,381,14,787,0.000270914306956151
"4310","North Hero",1,1,279,283,9,571,0.0001965591731537
"4311","Northfield",1,1,1050,1228,40,2318,0.000797940741454076
"4312","Norton",1,1,62,27,1,90,3.09813057510211e-05
"4313","Norwich",1,1,374,1893,21,2288,0.000787613639537069
"4314","Orange",1,1,290,190,6,486,0.000167299051055514
"4315","Orwell",1,1,321,307,4,632,0.000217557613718281
"4316","Panton",1,1,181,175,4,360,0.000123925223004084
"4317","Pawlet",1,1,356,385,8,749,0.000257833311194609
"4318","Peacham",1,1,151,298,13,462,0.000159037369521908
"4319","Peru",1,1,67,143,2,212,7.29781868801829e-05
"4320","Pittsfield",1,1,130,135,4,269,9.25996805224963e-05
"4321","Pittsford",1,1,740,720,7,1467,0.000504995283741643
"4322","Plainfield",1,1,215,506,29,750,0.000258177547925176
"4323","Plymouth",1,1,138,191,4,333,0.000114630831278778
"4324","Pomfret",1,1,216,401,3,620,0.000213426772951478
"4325","Poultney",1,1,675,840,21,1536,0.000528747618150759
"4326","Pownal",1,1,768,1013,31,1812,0.000623756955787224
"4327","Proctor",1,1,398,501,12,911,0.000313599661546446
"4328","Putney",1,1,248,1066,21,1335,0.000459556035306812
"4329","Randolph",1,1,910,1345,38,2293,0.000789334823189903
"4330","Reading",1,1,145,263,7,415,0.000142858243185264
"4331","Readsboro",1,1,169,234,7,410,0.000141137059532429
"4332","Richford",1,1,377,524,11,912,0.000313943898277013
"4333","Richmond",1,1,848,1532,25,2405,0.000827889337013396
"4334","Ripton",1,1,87,237,5,329,0.00011325388435651
"4335","Rochester",1,1,215,436,41,692,0.000238211817552295
"4336","Rockingham",1,1,743,1656,35,2434,0.000837872202199836
"4337","Roxbury",1,1,123,235,15,373,0.000128400300501454
"4338","Royalton",1,1,585,847,20,1452,0.00049983173278314
"4339","Rupert",1,1,224,217,5,446,0.000153529581832838
"4340","Rutland",4,4,3293,4142,63,7498,0.00258108700579062
"4341","Rutland Town",1,1,1308,1104,30,2442,0.000840626096044371
"4342","Ryegate",1,1,277,266,7,550,0.000189330201811795
"4343","Salisbury",1,1,238,236,5,479,0.000164889393941545
"4344","Sandgate",1,1,97,114,2,213,7.33224236107498e-05
"4345","Searsburg",1,1,22,30,1,53,1.82445467200457e-05
"4346","Shaftsbury",1,1,902,1265,33,2200,0.000757320807247181
"4347","Sharon",1,1,287,414,15,716,0.000246473499085901
"4348","Sheffield",1,1,131,139,6,276,9.50093376364646e-05
"4349","Shelburne",1,1,1493,2800,57,4350,0.00149742977796602
"4350","Sheldon",1,1,343,374,15,732,0.000251981286774971
"4351","Shoreham",1,1,256,366,7,629,0.000216524903526581
"4352","Shrewsbury",1,1,308,399,7,714,0.000245785025624767
"4353","South Burlington",1,1,3228,5601,99,8928,0.00307334553050129
"4354","South Hero",1,1,393,684,10,1087,0.000374185326126221
"4355","Springfield",1,1,1800,2538,64,4402,0.0015153300879555
"4356","St Albans",1,1,1045,1602,34,2681,0.000922898674649861
"4357","St Albans Town",1,1,1209,1328,20,2557,0.000880213320059565
"4358","St George",1,1,145,176,3,324,0.000111532700703676
"4359","St Johnsbury",1,1,1488,1577,31,3096,0.00106575691783512
"4360","Stamford",1,1,204,256,4,464,0.000159725842983042
"4361","Stannard",1,1,43,74,1,118,4.06199342068943e-05
"4362","Starksboro",1,1,315,547,13,875,0.000301207139246038
"4363","Stockbridge",1,1,141,218,6,365,0.000125646406656919
"4364","Stowe",1,1,939,1792,44,2775,0.000955256927323149
"4365","Strafford",1,1,159,526,10,695,0.000239244527743996
"4366","Stratton",1,1,63,67,2,132,4.54392484348309e-05
"4367","Sudbury",1,1,123,184,8,315,0.000108434570128574
"4368","Sunderland",1,1,210,271,9,490,0.000168675997977781
"4369","Sutton",1,1,230,189,10,429,0.0001476775574132
"4370","Swanton",1,1,1183,1302,16,2501,0.000860936063147819
"4371","Thetford",1,1,441,1125,17,1583,0.000544926744487404
"4372","Tinmouth",1,1,139,158,4,301,0.000103615255900637
"4373","Topsham",1,1,311,228,9,548,0.000188641728350662
"4374","Townshend",1,1,243,404,8,655,0.00022547505852132
"4375","Troy",1,1,298,344,2,644,0.000221688454485084
"4376","Tunbridge",1,1,297,379,11,687,0.000236490633899461
"4377","Underhill",1,1,646,1243,29,1918,0.000660246049227315
"4378","Vergennes",1,1,511,664,18,1193,0.000410674419566312
"4379","Vernon",1,1,601,510,11,1122,0.000386233611696063
"4380","Vershire",1,1,138,211,5,354,0.000121859802620683
"4381","Victory",1,1,34,24,0,58,1.99657303728802e-05
"4382","Waitsfield",1,1,338,769,18,1125,0.000387266321887763
"4383","Walden",1,1,201,296,6,503,0.000173151075475151
"4384","Wallingford",1,1,558,637,14,1209,0.000416182207255383
"4385","Waltham",1,1,95,119,8,222,7.64205541858519e-05
"4386","Wardsboro",1,1,169,230,5,404,0.000139071639149028
"4387","Warren",1,1,285,774,22,1081,0.00037211990574282
"4388","Washington",1,1,257,256,8,521,0.000179347336625355
"4389","Waterbury",1,1,972,1830,58,2860,0.000984517049421336
"4390","Waterford",1,1,389,291,13,693,0.000238556054282862
"4391","Waterville",1,1,130,203,2,335,0.000115319304739912
"4392","Weathersfield",1,1,691,829,28,1548,0.000532878458917562
"4393","Wells",1,1,295,229,11,535,0.000184166650853292
"4394","West Fairlee",1,1,152,164,5,321,0.000110499990511975
"4395","West Haven",1,1,65,58,4,127,4.37180647819964e-05
"4396","West Rutland",1,1,582,530,13,1125,0.000387266321887763
"4397","West Windsor",1,1,243,391,6,640,0.000220311507562816
"4398","Westfield",1,1,127,155,5,287,9.87959416727005e-05
"4399","Westford",1,1,375,690,16,1081,0.00037211990574282
"4400","Westminster",1,1,435,1203,23,1661,0.000571777209471622
"4401","Westmore",1,1,94,119,2,215,7.40108970718836e-05
"4402","Weston",1,1,128,250,7,385,0.000132531141268257
"4403","Weybridge",1,1,167,362,6,535,0.000184166650853292
"4404","Wheelock",1,1,148,151,5,304,0.000104647966092338
"4405","Whiting",1,1,79,126,2,207,7.12570032273484e-05
"4406","Whitingham",1,1,289,332,6,627,0.000215836430065447
"4407","Williamstown",1,1,865,689,24,1578,0.000543205560834569
"4408","Williston",1,1,1931,2938,60,4929,0.00169674284496425
"4409","Wilmington",1,1,479,696,23,1198,0.000412395603219147
"4410","Windham",1,1,89,134,3,226,7.77975011081195e-05
"4411","Windsor",1,1,617,1091,11,1719,0.000591742939844502
"4412","Winhall",1,1,212,273,7,492,0.000169364471438915
"4413","Winooski",1,1,781,1685,42,2508,0.000863345720261787
"4414","Wolcott",1,1,241,473,11,725,0.000249571629661003
"4415","Woodbury",1,1,204,277,7,488,0.000167987524516648
"4416","Woodford",1,1,81,123,4,208,7.16012399579153e-05
"4417","Woodstock",1,1,708,1260,20,1988,0.000684342620366999
"4418","Worcester",1,1,158,359,17,534,0.000183822414122725
"4419","Adams",31,31,3617,1257,36,4910,0.00169020234708348
"4420","Asotin",26,26,5111,3207,73,8391,0.00288849040618686
"4421","Benton",178,178,37299,18175,308,55782,0.0192022133044829
"4422","Chelan",80,80,12268,7025,141,19434,0.00668989662183715
"4423","Clallam",93,93,16050,14639,348,31037,0.0106840754066049
"4424","Clark",180,180,83300,74658,1061,159019,0.054740180658018
"4425","Columbia",13,13,1364,565,15,1944,0.000669196204222055
"4426","Cowlitz",92,92,17470,18856,288,36614,0.0126038836529765
"4427","Douglas",45,45,8194,3947,83,12224,0.00420794979444979
"4428","Ferry",36,36,1969,1156,57,3182,0.00109536127666388
"4429","Franklin",75,75,9220,4500,80,13800,0.00475046688182323
"4430","Garfield",12,12,874,340,10,1224,0.000421345758213886
"4431","Grant",65,65,17539,7662,189,25390,0.00874017058909361
"4432","Grays Harbor",55,55,14029,15707,290,30026,0.0103360520720018
"4433","Island",65,65,15858,14667,224,30749,0.0105849352282016
"4434","Jefferson",50,50,6055,10427,160,16642,0.00572878767009436
"4435","King",2616,2616,264757,498782,5374,768913,0.264688097210387
"4436","Kitsap",185,185,48995,53548,950,103493,0.0356260919565603
"4437","Kittitas",58,58,7857,5768,145,13770,0.00474013977990622
"4438","Klickitat",29,29,4806,3834,79,8719,0.00300140005381281
"4439","Lewis",79,79,18298,9453,290,28041,0.00965274216182646
"4440","Lincoln",46,46,3989,1697,48,5734,0.00197385341307061
"4441","Mason",57,57,10484,11331,245,22060,0.00759386227630583
"4442","Okanogan",222,222,8336,5511,134,13981,0.00481277373005584
"4443","Pacific",37,37,4614,5538,117,10269,0.0035349669861915
"4444","Pend Oreille",27,27,3671,2292,83,6046,0.00208125527300748
"4445","Pierce",374,374,131548,138119,2026,271693,0.0935267100379129
"4446","San Juan",17,17,2904,5784,88,8776,0.00302102154745512
"4447","Skagit",116,116,16269,15739,297,32305,0.0111205675809637
"4448","Skamania",25,25,2678,2361,40,5079,0.00174837835454929
"4449","Snohomish",698,698,125380,145434,2052,272866,0.0939304997228679
"4450","Spokane",286,286,88448,70105,1360,159913,0.0550479282951448
"4451","Stevens",55,55,10789,5763,175,16727,0.00575804779219255
"4452","Thurston",281,281,44190,57551,1081,102822,0.0353951091103499
"4453","Wahkiakum",11,11,1165,1018,22,2205,0.000759041990900016
"4454","Walla Walla",59,59,10972,6327,134,17433,0.00600107892397278
"4455","Whatcom",119,119,29982,35787,654,66423,0.0228652363544452
"4456","Whitman",56,56,7158,5860,114,13132,0.00452051674580454
"4457","Yakima",137,137,33030,21478,317,54825,0.0188727787533303
"4458","Adams",20,20,4890,5447,77,10414,0.0035848813121237
"4459","Ashland",26,26,3313,5705,55,9073,0.00312325985643349
"4460","Barron",36,36,12030,11696,126,23852,0.00821073449748171
"4461","Bayfield",29,29,3753,5845,70,9668,0.0033280807111208
"4462","Brown",91,91,67113,54889,666,122668,0.0422268312651806
"4463","Buffalo",23,23,3502,3998,62,7562,0.0026031181565469
"4464","Burnett",24,24,4743,4499,41,9283,0.00319554956985254
"4465","Calumet",34,34,14719,10289,161,25169,0.00866409427163832
"4466","Chippewa",38,38,15450,14751,198,30399,0.0104644523725032
"4467","Clark",63,63,7965,6964,130,15059,0.00518386092560696
"4468","Columbia",43,43,14956,14300,158,29414,0.0101253791928948
"4469","Crawford",27,27,3680,4656,49,8385,0.00288642498580346
"4470","Dane",214,214,90356,181032,1461,272849,0.0939246476984483
"4471","Dodge",52,52,27200,16689,283,44172,0.0152056248626011
"4472","Door",30,30,8910,8367,118,17395,0.00598799792821124
"4473","Douglas",31,31,8448,16534,125,25107,0.00864275159434317
"4474","Dunn",35,35,10878,12039,151,23068,0.00794085290071726
"4475","Eau Claire",57,57,24644,30049,371,55064,0.0189550513319358
"4476","Florence",8,8,1703,993,18,2714,0.000934258486758568
"4477","Fond du Lac",53,53,33291,19214,297,52802,0.0181763878473935
"4478","Forest",18,18,2608,2509,27,5144,0.00177075374203614
"4479","Grant",55,55,12113,12865,113,25091,0.0086372438066541
"4480","Green",39,39,8497,9575,101,18173,0.00625581410459229
"4481","Green Lake",16,16,6472,3605,55,10132,0.00348780655410384
"4482","Iowa",35,35,5348,7122,43,12513,0.00430743420958363
"4483","Iron",19,19,1884,1956,25,3865,0.00133047496364107
"4484","Jackson",27,27,4387,5249,47,9683,0.0033332442620793
"4485","Jefferson",44,44,23775,17926,240,41941,0.0144376327167064
"4486","Juneau",29,29,6478,5734,73,12285,0.00422894823501437
"4487","Kenosha",69,69,35583,40102,354,76039,0.0261754167555766
"4488","Kewaunee",14,14,5947,5166,78,11191,0.00385235325177419
"4489","La Crosse",42,42,28286,33157,348,61791,0.0212707318184594
"4490","Lafayette",28,28,3926,4415,37,8378,0.00288401532868949
"4491","Langlade",27,27,6235,4751,64,11050,0.00380381587276425
"4492","Lincoln",25,25,8032,7482,112,15626,0.00537904315183839
"4493","Manitowoc",42,42,23025,20655,300,43980,0.0151395314103323
"4494","Marathon",121,121,36394,30897,505,67796,0.0233378733855136
"4495","Marinette",35,35,11870,10204,125,22199,0.00764171118185463
"4496","Marquette",19,19,4604,3785,36,8425,0.00290019445502614
"4497","Menominee",2,2,288,1412,6,1706,0.000587267862347133
"4498","Milwaukee",462,462,180041,297260,2227,479528,0.165071150935285
"4499","Monroe",36,36,10280,8982,114,19376,0.00666993089146427
"4500","Oconto",30,30,11043,8533,126,19702,0.00678215206562908
"4501","Oneida",29,29,11349,10468,135,21952,0.0075566847094046
"4502","Outagamie",90,90,48809,40369,507,89685,0.0308728711808925
"4503","Ozaukee",49,49,34901,17708,245,52854,0.018194288157383
"4504","Pepin",11,11,1853,2184,19,4056,0.00139622417917935
"4505","Pierce",28,28,10437,11177,148,21762,0.00749127973059689
"4506","Polk",38,38,11895,11178,132,23205,0.00798801333280493
"4507","Portage",40,40,16546,21861,299,38706,0.0133240268933225
"4508","Price",44,44,4311,4349,55,8715,0.00300002310689054
"4509","Racine",68,68,52449,48226,459,101134,0.0348140375091529
"4510","Richland",33,33,4841,4505,37,9383,0.00322997324290923
"4511","Rock",83,83,33055,46598,409,80062,0.0275602811226472
"4512","Rusk",33,33,3985,3820,71,7876,0.00271120848994491
"4513","Sauk",55,55,14415,15708,182,30305,0.0104320941198299
"4514","Sawyer",24,24,4950,4410,62,9422,0.00324339847540134
"4515","Shawano",43,43,12149,8656,130,20935,0.00720659595441807
"4516","Sheboygan",58,58,34456,27606,323,62385,0.0214752084364161
"4517","St Croix",37,37,22679,18784,200,41663,0.0143419349056088
"4518","Taylor",30,30,5535,3783,87,9405,0.0032375464509817
"4519","Trempealeau",26,26,5883,8077,71,14031,0.00482998556658418
"4520","Vernon",33,33,6773,7924,87,14784,0.00508919582470106
"4521","Vilas",15,15,8153,5713,74,13940,0.0047986600241026
"4522","Walworth",38,38,28752,19175,278,48205,0.0165939315969774
"4523","Washburn",30,30,4766,4705,59,9530,0.00328057604230256
"4524","Washington",46,46,50640,21235,341,72216,0.0248593997346193
"4525","Waukesha",205,205,154910,73618,966,229494,0.0790002642447203
"4526","Waupaca",38,38,15952,10794,162,26908,0.00926272194609416
"4527","Waushara",26,26,6888,5119,66,12073,0.00415597004813419
"4528","Winnebago",77,77,46538,40937,611,88086,0.030322436648716
"4529","Wood",45,45,20592,18950,336,39878,0.0137274723415469
"4530","Barbour",23,23,3975,2636,29,6640,0.00228573189096422
"4531","Berkeley",59,59,20724,11888,153,32765,0.0112789164770245
"4532","Boone",37,37,4163,5890,50,10103,0.0034778236889174
"4533","Braxton",22,22,2964,3014,21,5999,0.00206507614667084
"4534","Brooke",27,27,5147,5460,73,10680,0.0036764482824545
"4535","Cabell",68,68,20777,16328,225,37330,0.0128503571520624
"4536","Calhoun",10,10,1569,1253,25,2847,0.000980041971923966
"4537","Clay",13,13,2183,1824,34,4041,0.00139106062822085
"4538","Doddridge",13,13,2340,792,21,3153,0.00108537841147744
"4539","Fayette",39,39,7767,8860,89,16716,0.00575426118815631
"4540","Gilmer",12,12,1660,1153,21,2834,0.000975566894426596
"4541","Grant",15,15,4005,944,17,4966,0.00170947960399523
"4542","Greenbrier",36,36,8278,6039,78,14395,0.00495528773651053
"4543","Hampshire",23,23,5465,2444,37,7946,0.00273530506108459
"4544","Hancock",28,28,7224,6829,90,14143,0.00486854008040768
"4545","Hardy",14,14,3600,1606,14,5220,0.00179691573355922
"4546","Harrison",93,93,16913,13102,177,30192,0.0103931953692759
"4547","Jackson",38,38,7604,5332,61,12997,0.00447404478717801
"4548","Jefferson",29,29,10442,9202,89,19733,0.00679282340427665
"4549","Kanawha",183,183,43777,42321,348,86446,0.0297578884105863
"4550","Lewis",24,24,3500,1863,50,5413,0.00186335342255863
"4551","Lincoln",35,35,4076,4033,45,8154,0.00280690630104251
"4552","Logan",52,52,6513,7760,45,14318,0.00492878150825688
"4553","Marion",75,75,12717,12082,186,24985,0.00860075471321401
"4554","Marshall",45,45,8443,6379,102,14924,0.00513738896698043
"4555","Mason",38,38,6451,5374,62,11887,0.00409194201624875
"4556","McDowell",42,42,2729,4464,26,7219,0.00248504495796246
"4557","Mercer",61,61,12914,9052,107,22073,0.0075983373538032
"4558","Mineral",35,35,7640,3444,69,11153,0.00383927225601264
"4559","Mingo",39,39,4544,5912,45,10501,0.00361482990768302
"4560","Monongalia",92,92,17459,16136,203,33798,0.0116345130197001
"4561","Monroe",17,17,3596,2321,44,5961,0.0020519951509093
"4562","Morgan",13,13,4474,2260,51,6785,0.00233564621689642
"4563","Nicholas",29,29,5389,4718,61,10168,0.00350019907640425
"4564","Ohio",38,38,11539,8406,122,20067,0.006907798472286
"4565","Pendleton",13,13,2120,1367,11,3498,0.00120414008352302
"4566","Pleasants",11,11,2023,1333,11,3367,0.00115904507181875
"4567","Pocahontas",15,15,2282,1565,35,3882,0.00133632698806071
"4568","Preston",35,35,7813,3944,87,11844,0.00407713983683437
"4569","Putnam",48,48,15587,9223,100,24910,0.00857493695842149
"4570","Raleigh",63,63,18338,11723,149,30210,0.0103993916304261
"4571","Randolph",37,37,6495,4880,61,11436,0.00393669125076308
"4572","Ritchie",15,15,3060,1060,29,4149,0.00142823819512207
"4573","Roane",20,20,3424,2599,39,6062,0.00208676306069655
"4574","Summers",15,15,2963,2489,33,5485,0.00188813846715945
"4575","Taylor",18,18,3839,2590,25,6454,0.00222170385907878
"4576","Tucker",11,11,2151,1382,13,3546,0.00122066344659023
"4577","Tyler",12,12,2770,1386,36,4192,0.00144304037453645
"4578","Upshur",29,29,6134,2998,51,9183,0.00316112589679585
"4579","Wayne",37,37,9998,8363,100,18461,0.00635495428299555
"4580","Webster",14,14,1706,1943,20,3669,0.00126300456444996
"4581","Wetzel",22,22,3609,3293,44,6946,0.00239106833051769
"4582","Wirt",9,9,1712,892,19,2623,0.00090293294427698
"4583","Wood",85,85,24636,13824,187,38647,0.013303716926219
"4584","Wyoming",39,39,4930,3666,31,8627,0.00296973027460065
"4585","Albany",22,22,8879,7032,296,16207,0.00557904469229776
"4586","Big Horn",13,13,4232,960,46,5238,0.00180311199470943
"4587","Campbell",35,35,12407,2464,125,14996,0.00516217401158124
"4588","Carbon",19,19,4758,2157,89,7004,0.00241103406089057
"4589","Converse",19,19,4446,1183,60,5689,0.0019583627601951
"4590","Crook",17,17,2836,500,27,3363,0.00115766812489649
"4591","Fremont",32,32,11428,5337,179,16944,0.00583274716272556
"4592","Goshen",20,20,4114,1566,52,5732,0.00197316493960947
"4593","Hot Springs",4,4,1811,623,18,2452,0.00084406846335004
"4594","Johnson",17,17,3231,736,38,4005,0.00137866810592044
"4595","Laramie",58,58,25947,13170,421,39538,0.0136104318531541
"4596","Lincoln",18,18,6424,1363,67,7854,0.00270363528187244
"4597","Natrona",46,46,21503,9852,330,31685,0.0109071408080122
"4598","Niobrara",6,6,1064,230,9,1303,0.000448540459928672
"4599","Park",29,29,10660,2939,162,13761,0.00473704164933112
"4600","Platte",13,13,3127,1318,52,4497,0.00154803257735935
"4601","Sheridan",29,29,9635,4041,154,13830,0.00476079398374024
"4602","Sublette",9,9,2846,730,46,3622,0.00124682543811331
"4603","Sweetwater",36,36,10638,5201,229,16068,0.00553119578674896
"4604","Teton",16,16,5124,5971,167,11262,0.00387679405964444
"4605","Uinta",11,11,6080,1812,96,7988,0.0027497630037684
"4606","Washakie",5,5,3200,855,33,4088,0.00140723975455749
"4607","Weston",8,8,2739,580,38,3357,0.00115560270451309
